value_a,value_b,value_c,value_d,result,operation
8,0,14,89,111,+
11,11,42,16,80,+
6,93,85,13,197,+
76,4,86,42,208,+
60,19,55,6,140,+
92,10,0,2,104,+
30,48,11,92,181,+
43,70,64,32,209,+
11,75,22,65,173,+
68,55,99,79,301,+
19,45,73,28,165,+
38,63,33,75,209,+
99,38,19,60,216,+
88,34,8,33,163,+
94,5,23,73,195,+
98,5,17,3,123,+
51,79,21,87,238,+
70,35,80,97,282,+
76,80,41,38,235,+
52,45,25,76,198,+
11,65,16,29,121,+
73,77,29,3,182,+
56,31,33,47,167,+
90,50,18,77,235,+
96,31,18,90,235,+
24,45,8,69,146,+
88,66,79,73,306,+
34,63,34,50,181,+
64,66,14,15,159,+
90,63,8,64,225,+
49,60,1,23,133,+
44,22,55,95,216,+
55,0,71,97,223,+
67,74,36,14,191,+
69,75,26,16,186,+
96,54,22,55,227,+
20,84,91,7,202,+
85,46,53,26,210,+
5,64,87,69,225,+
69,49,6,4,128,+
75,97,87,0,259,+
49,38,54,6,147,+
1,47,64,36,148,+
13,83,35,48,179,+
50,23,34,50,157,+
46,40,6,97,189,+
44,37,43,65,189,+
51,8,93,55,207,+
30,45,20,83,178,+
22,7,83,78,190,+
88,4,21,9,122,+
59,82,11,44,196,+
7,35,87,46,175,+
44,89,91,50,274,+
57,60,49,38,204,+
29,12,44,4,89,+
96,20,55,40,211,+
58,84,74,59,275,+
40,16,84,53,193,+
39,76,80,53,248,+
29,29,32,6,96,+
75,79,89,67,310,+
53,79,13,96,241,+
43,27,45,67,182,+
82,88,2,66,238,+
28,95,98,39,260,+
5,63,49,16,133,+
15,80,71,67,233,+
48,5,0,32,85,+
88,21,96,23,228,+
12,58,52,0,122,+
30,1,46,71,148,+
49,66,80,55,250,+
3,43,21,96,163,+
81,73,59,38,251,+
70,72,38,83,263,+
63,46,36,52,197,+
56,66,6,5,133,+
33,84,93,28,238,+
17,30,92,70,209,+
38,43,94,88,263,+
86,30,20,35,171,+
20,66,18,79,183,+
78,89,9,91,267,+
43,89,12,24,168,+
99,81,75,41,296,+
44,60,68,83,255,+
50,10,62,12,134,+
18,43,5,92,158,+
27,82,50,60,219,+
83,43,63,91,280,+
20,67,1,32,120,+
59,49,85,85,278,+
14,11,47,66,138,+
73,46,15,44,178,+
87,83,78,75,323,+
15,18,42,81,156,+
96,37,26,52,211,+
62,28,45,90,225,+
72,90,41,4,207,+
57,25,35,95,212,+
15,20,49,69,153,+
51,94,40,23,208,+
18,20,14,30,82,+
55,46,38,90,229,+
37,25,70,90,222,+
70,3,52,9,134,+
14,80,92,36,222,+
87,6,10,69,172,+
48,46,55,22,171,+
31,60,43,76,210,+
89,27,25,17,158,+
48,10,68,12,138,+
35,63,1,96,195,+
23,45,53,22,143,+
74,12,30,32,148,+
57,81,49,49,236,+
37,82,70,7,196,+
91,1,54,97,243,+
89,12,91,19,211,+
70,87,44,73,274,+
84,40,10,14,148,+
40,22,62,25,149,+
23,87,7,44,161,+
33,4,15,92,144,+
36,62,78,48,224,+
7,38,37,2,84,+
33,34,16,6,89,+
7,88,18,30,143,+
0,11,71,94,176,+
1,53,57,81,192,+
56,55,45,67,223,+
67,19,65,54,205,+
97,8,78,16,199,+
35,44,32,67,178,+
86,1,29,28,144,+
25,89,76,62,252,+
91,2,9,52,154,+
92,77,66,37,272,+
0,76,6,26,108,+
94,27,27,89,237,+
55,95,90,34,274,+
19,62,59,58,198,+
76,20,85,12,193,+
87,69,32,71,259,+
24,73,21,72,190,+
92,96,22,28,238,+
6,87,80,46,219,+
9,25,73,20,127,+
21,25,54,64,164,+
0,28,72,52,152,+
69,51,3,10,133,+
13,95,50,35,193,+
93,35,64,18,210,+
98,24,36,99,257,+
53,89,32,26,200,+
93,7,54,92,246,+
73,81,10,89,253,+
50,26,72,99,247,+
75,24,80,29,208,+
50,34,44,55,183,+
11,59,64,73,207,+
36,6,77,49,168,+
23,27,92,10,152,+
36,20,41,46,143,+
65,50,46,65,226,+
28,45,54,78,205,+
73,78,52,32,235,+
68,25,35,14,142,+
20,92,24,26,162,+
14,27,9,94,144,+
94,49,53,24,220,+
22,93,28,70,213,+
22,95,55,44,216,+
73,46,13,58,190,+
57,6,63,56,182,+
99,18,59,56,232,+
34,14,56,48,152,+
32,72,82,68,254,+
64,52,77,85,278,+
49,80,59,51,239,+
19,95,46,55,215,+
34,5,4,7,50,+
2,39,33,48,122,+
65,60,66,43,234,+
96,30,60,72,258,+
80,78,27,94,279,+
33,18,74,10,135,+
80,20,33,15,148,+
21,98,14,29,162,+
42,55,53,74,224,+
75,4,92,76,247,+
6,80,99,31,216,+
63,17,93,6,179,+
7,6,16,46,75,+
65,37,69,2,173,+
36,65,27,6,134,+
23,88,25,16,152,+
20,38,62,72,192,+
76,2,66,44,188,+
58,21,23,17,119,+
53,94,85,43,275,+
41,27,59,23,150,+
55,70,40,69,234,+
47,42,11,77,177,+
96,45,5,80,226,+
87,11,47,6,151,+
44,98,10,18,170,+
32,99,14,52,197,+
56,80,96,0,232,+
28,59,66,0,153,+
0,13,95,69,177,+
29,28,21,23,101,+
66,4,94,17,181,+
15,21,96,87,219,+
70,55,95,51,271,+
0,50,29,58,137,+
18,18,56,44,136,+
49,65,39,86,239,+
69,80,72,95,316,+
8,80,85,81,254,+
5,67,8,87,167,+
64,14,7,5,90,+
90,32,2,39,163,+
25,33,87,3,148,+
96,44,55,92,287,+
88,68,42,24,222,+
10,58,69,3,140,+
88,83,24,52,247,+
69,89,73,73,304,+
36,19,5,89,149,+
53,28,9,94,184,+
68,98,52,73,291,+
44,93,71,64,272,+
66,95,87,34,282,+
71,86,98,64,319,+
28,97,52,93,270,+
15,98,26,70,209,+
41,64,41,76,222,+
52,48,21,18,139,+
93,38,52,49,232,+
97,96,7,59,259,+
12,34,61,43,150,+
88,92,76,20,276,+
80,6,42,35,163,+
85,95,93,57,330,+
39,5,60,7,111,+
23,57,0,15,95,+
72,66,46,86,270,+
31,69,84,87,271,+
28,86,49,30,193,+
27,28,92,47,194,+
66,45,8,56,175,+
29,15,55,88,187,+
69,80,20,18,187,+
60,23,96,48,227,+
1,44,11,68,124,+
77,74,64,96,311,+
22,7,23,23,75,+
23,26,65,71,185,+
21,61,13,95,190,+
15,27,10,28,80,+
70,19,79,79,247,+
33,28,47,68,176,+
15,1,66,54,136,+
93,52,43,96,284,+
73,99,80,22,274,+
49,74,59,57,239,+
32,1,69,12,114,+
91,62,47,51,251,+
30,39,58,16,143,+
40,54,38,93,225,+
43,91,59,18,211,+
32,92,57,41,222,+
51,8,51,22,132,+
72,59,90,92,313,+
12,44,82,60,198,+
42,9,85,57,193,+
59,9,51,65,184,+
80,70,8,32,190,+
74,79,40,23,216,+
97,76,94,15,282,+
7,32,37,6,82,+
98,35,28,59,220,+
48,75,51,87,261,+
30,72,34,50,186,+
22,60,94,68,244,+
1,81,7,31,120,+
48,1,84,75,208,+
83,61,64,91,299,+
6,56,51,12,125,+
68,1,54,86,209,+
53,43,32,86,214,+
11,50,5,56,122,+
59,28,9,82,178,+
58,62,36,35,191,+
73,24,98,29,224,+
16,45,42,69,172,+
73,44,9,20,146,+
55,4,68,49,176,+
96,13,32,97,238,+
67,59,57,0,183,+
23,42,40,1,106,+
22,20,8,1,51,+
77,57,89,4,227,+
70,98,24,96,288,+
22,77,14,17,130,+
32,34,42,83,191,+
81,77,19,23,200,+
75,12,42,47,176,+
14,64,9,84,171,+
78,48,33,62,221,+
16,69,4,71,160,+
10,61,37,80,188,+
31,25,59,9,124,+
87,90,82,21,280,+
95,3,33,6,137,+
89,74,95,56,314,+
70,61,54,15,200,+
77,78,21,7,183,+
2,88,15,58,163,+
3,96,54,68,221,+
7,12,79,7,105,+
18,62,91,97,268,+
84,3,59,79,225,+
44,65,42,0,151,+
15,72,45,17,149,+
16,22,58,24,120,+
18,95,49,92,254,+
58,74,74,98,304,+
66,9,10,37,122,+
54,28,16,38,136,+
33,50,71,29,183,+
65,20,36,34,155,+
52,31,79,37,199,+
29,97,34,77,237,+
19,81,71,59,230,+
65,51,20,72,208,+
90,42,10,72,214,+
75,36,64,60,235,+
99,60,90,39,288,+
24,35,47,1,107,+
63,78,73,17,231,+
61,20,19,48,148,+
72,69,40,16,197,+
33,88,31,40,192,+
13,59,65,22,159,+
62,26,0,2,90,+
35,70,16,70,191,+
98,67,21,46,232,+
70,92,49,12,223,+
81,19,32,60,192,+
66,84,36,15,201,+
75,10,86,2,173,+
73,86,41,83,283,+
41,13,77,18,149,+
59,34,52,47,192,+
38,64,32,33,167,+
99,97,89,89,374,+
52,45,41,92,230,+
31,40,5,18,94,+
51,57,66,46,220,+
17,99,88,85,289,+
26,17,74,38,155,+
88,34,40,73,235,+
91,91,87,31,300,+
52,47,83,36,218,+
35,76,67,78,256,+
73,27,17,1,118,+
85,41,47,18,191,+
58,56,92,82,288,+
71,92,22,3,188,+
51,65,17,70,203,+
42,23,70,92,227,+
91,82,15,25,213,+
60,77,59,34,230,+
66,93,95,73,327,+
70,12,18,44,144,+
7,76,77,22,182,+
20,49,76,87,232,+
80,43,86,41,250,+
89,75,20,14,198,+
60,75,55,69,259,+
18,35,75,1,129,+
94,69,11,67,241,+
67,2,71,69,209,+
34,40,12,44,130,+
68,55,13,75,211,+
17,78,82,13,190,+
88,34,79,64,265,+
75,85,56,12,228,+
8,87,15,59,169,+
13,13,92,33,151,+
93,67,1,44,205,+
60,71,20,55,206,+
16,70,68,52,206,+
50,77,82,99,308,+
13,41,5,15,74,+
77,59,85,49,270,+
67,31,50,5,153,+
66,87,21,88,262,+
60,70,21,79,230,+
29,72,23,86,210,+
33,65,19,59,176,+
27,76,4,43,150,+
10,97,44,63,214,+
16,10,41,95,162,+
16,5,87,40,148,+
52,26,27,37,142,+
90,59,22,61,232,+
88,96,14,71,269,+
24,39,41,76,180,+
53,73,34,68,228,+
90,85,68,68,311,+
74,8,59,23,164,+
88,40,67,22,217,+
27,76,5,17,125,+
34,82,7,32,155,+
38,99,65,23,225,+
78,47,62,8,195,+
38,11,12,50,111,+
38,46,44,71,199,+
39,60,36,34,169,+
37,40,69,65,211,+
1,43,35,63,142,+
49,39,29,40,157,+
53,76,70,7,206,+
27,51,11,60,149,+
83,92,78,6,259,+
58,70,66,97,291,+
2,45,89,33,169,+
39,97,69,76,281,+
96,40,34,78,248,+
25,92,25,74,216,+
69,34,19,25,147,+
58,90,39,64,251,+
87,89,21,80,277,+
51,63,90,63,267,+
57,20,79,31,187,+
62,62,81,98,303,+
20,45,12,3,80,+
88,17,2,34,141,+
36,41,74,79,230,+
89,99,61,99,348,+
21,70,11,71,173,+
7,70,95,5,177,+
80,28,79,58,245,+
46,35,36,98,215,+
31,25,48,81,185,+
40,42,61,59,202,+
84,70,88,98,340,+
34,36,56,63,189,+
53,92,22,90,257,+
90,45,33,59,227,+
80,93,47,75,295,+
4,17,13,85,119,+
57,28,71,22,178,+
98,0,19,21,138,+
67,21,41,74,203,+
10,2,5,23,40,+
59,44,11,32,146,+
38,79,79,88,284,+
58,4,48,81,191,+
83,22,4,44,153,+
18,57,51,8,134,+
4,60,97,58,219,+
88,34,67,67,256,+
81,47,52,48,228,+
13,12,70,71,166,+
47,33,26,78,184,+
70,46,59,43,218,+
9,16,51,57,133,+
54,16,16,37,123,+
6,46,20,58,130,+
54,55,63,96,268,+
28,29,3,8,68,+
97,95,20,44,256,+
21,56,29,46,152,+
87,18,29,65,199,+
49,4,47,4,104,+
25,38,88,58,209,+
54,36,44,41,175,+
32,4,59,42,137,+
90,23,6,32,151,+
5,43,83,34,165,+
43,70,27,20,160,+
35,30,84,98,247,+
24,19,42,93,178,+
89,4,11,27,131,+
5,95,60,96,256,+
70,86,9,9,174,+
66,77,79,85,307,+
54,51,38,26,169,+
61,36,81,45,223,+
58,91,51,21,221,+
71,65,24,34,194,+
22,78,13,90,203,+
65,12,9,98,184,+
78,75,83,79,315,+
78,99,21,9,207,+
94,23,59,48,224,+
35,68,81,59,243,+
13,80,6,26,125,+
8,82,35,94,219,+
47,20,95,36,198,+
93,20,45,38,196,+
74,59,41,50,224,+
24,65,35,59,183,+
41,33,80,56,210,+
80,70,85,32,267,+
6,85,82,59,232,+
82,62,29,99,272,+
83,44,20,39,186,+
34,25,45,21,125,+
39,55,53,23,170,+
42,55,20,16,133,+
53,44,8,85,190,+
19,32,53,84,188,+
93,38,10,4,145,+
65,81,11,79,236,+
86,25,62,82,255,+
30,66,22,12,130,+
14,3,25,37,79,+
50,78,86,59,273,+
11,92,20,43,166,+
0,21,62,45,128,+
92,76,46,53,267,+
83,58,23,14,178,+
93,13,86,52,244,+
45,41,26,48,160,+
14,85,7,47,153,+
32,95,99,31,257,+
52,5,25,95,177,+
81,16,8,12,117,+
39,36,80,21,176,+
14,58,6,22,100,+
98,81,26,87,292,+
73,27,43,34,177,+
96,69,84,39,288,+
39,83,30,74,226,+
29,26,74,0,129,+
54,41,59,70,224,+
43,46,20,17,126,+
98,13,64,45,220,+
44,59,16,51,170,+
71,36,38,56,201,+
62,65,95,57,279,+
23,97,48,63,231,+
59,58,26,91,234,+
62,25,49,83,219,+
90,51,11,84,236,+
65,42,0,0,107,+
27,0,51,1,79,+
13,92,47,71,223,+
58,84,77,72,291,+
17,81,39,61,198,+
88,80,89,48,305,+
53,23,53,26,155,+
60,0,97,82,239,+
35,50,52,18,155,+
59,89,66,78,292,+
90,89,41,80,300,+
12,93,0,1,106,+
27,72,40,25,164,+
2,68,4,90,164,+
99,58,9,98,264,+
67,69,12,51,199,+
4,27,16,37,84,+
83,47,20,41,191,+
29,25,58,27,139,+
28,29,0,57,114,+
12,9,14,96,131,+
74,10,39,7,130,+
63,79,67,64,273,+
17,10,54,58,139,+
36,15,60,35,146,+
0,49,9,52,110,+
93,39,90,36,258,+
29,92,63,95,279,+
98,11,43,87,239,+
97,71,76,26,270,+
60,85,41,47,233,+
96,81,4,9,190,+
56,50,85,52,243,+
86,24,90,30,230,+
37,92,21,65,215,+
81,95,10,57,243,+
53,45,19,4,121,+
55,20,81,47,203,+
98,59,70,19,246,+
51,34,44,2,131,+
45,0,14,63,122,+
77,6,84,8,175,+
25,65,62,37,189,+
99,57,94,88,338,+
16,30,90,36,172,+
63,14,46,32,155,+
56,85,98,6,245,+
96,39,84,20,239,+
44,39,90,36,209,+
47,62,33,36,178,+
94,16,70,37,217,+
56,91,67,26,240,+
30,1,94,45,170,+
10,86,92,22,210,+
27,71,8,6,112,+
20,14,93,73,200,+
94,35,98,29,256,+
74,6,77,3,160,+
92,13,29,37,171,+
67,55,77,42,241,+
86,17,39,28,170,+
9,15,65,38,127,+
33,61,56,30,180,+
36,37,19,34,126,+
1,56,53,4,114,+
3,81,51,73,208,+
45,48,12,33,138,+
55,27,32,35,149,+
67,30,11,7,115,+
71,7,21,61,160,+
97,18,20,67,202,+
77,53,20,26,176,+
55,89,9,1,154,+
28,88,77,83,276,+
94,12,50,94,250,+
73,56,32,67,228,+
0,72,28,15,115,+
37,98,43,78,256,+
49,70,57,94,270,+
37,49,56,35,177,+
75,81,67,24,247,+
82,10,6,95,193,+
62,43,32,19,156,+
31,20,98,58,207,+
65,10,43,33,151,+
40,22,85,21,168,+
93,31,28,74,226,+
47,64,29,75,215,+
5,31,59,42,137,+
0,55,64,65,184,+
58,90,38,94,280,+
30,34,6,90,160,+
33,1,89,20,143,+
56,1,20,14,91,+
71,13,54,77,215,+
99,38,37,70,244,+
63,30,47,94,234,+
76,21,60,63,220,+
10,18,3,20,51,+
82,3,97,15,197,+
35,69,12,90,206,+
73,81,29,47,230,+
60,14,4,99,177,+
2,15,17,31,65,+
80,65,17,11,173,+
40,44,45,59,188,+
61,83,4,98,246,+
0,87,91,18,196,+
73,62,74,27,236,+
87,88,26,90,291,+
91,43,47,45,226,+
50,80,70,47,247,+
71,64,30,76,241,+
90,60,42,54,246,+
77,84,2,26,189,+
95,7,59,82,243,+
69,10,55,24,158,+
80,10,48,76,214,+
52,72,51,98,273,+
91,23,12,85,211,+
40,71,93,79,283,+
93,21,31,43,188,+
3,65,41,6,115,+
61,5,90,30,186,+
87,97,81,60,325,+
10,50,30,49,139,+
41,58,32,5,136,+
61,99,52,26,238,+
72,57,62,86,277,+
77,92,85,71,325,+
86,4,72,8,170,+
43,31,74,89,237,+
82,79,97,78,336,+
85,94,40,74,293,+
69,95,17,86,267,+
21,97,53,2,173,+
75,23,69,22,189,+
43,24,4,48,119,+
93,19,55,14,181,+
98,42,43,82,265,+
12,46,26,26,110,+
22,67,80,39,208,+
20,74,14,78,186,+
18,95,13,73,199,+
0,60,51,83,194,+
88,84,95,0,267,+
64,57,90,77,288,+
40,69,10,29,148,+
36,91,66,80,273,+
13,20,20,91,144,+
82,38,20,18,158,+
46,59,91,52,248,+
56,23,60,58,197,+
10,42,18,40,110,+
21,8,10,17,56,+
12,78,12,39,141,+
93,43,46,33,215,+
69,57,99,55,280,+
23,41,9,32,105,+
87,86,89,73,335,+
64,84,37,67,252,+
61,68,88,26,243,+
10,37,19,15,81,+
41,78,34,21,174,+
8,41,80,42,171,+
62,65,59,71,257,+
73,53,66,21,213,+
53,95,84,70,302,+
68,61,63,61,253,+
35,44,86,31,196,+
83,86,89,36,294,+
5,44,54,3,106,+
67,71,83,18,239,+
47,26,26,16,115,+
72,46,65,10,193,+
22,0,74,47,143,+
56,82,14,13,165,+
56,28,59,79,222,+
18,8,4,52,82,+
21,11,8,54,94,+
51,6,45,15,117,+
23,18,59,44,144,+
3,58,4,12,77,+
46,99,85,58,288,+
8,40,13,88,149,+
44,36,20,10,110,+
47,75,67,30,219,+
84,70,70,2,226,+
19,49,61,13,142,+
55,70,40,33,198,+
23,27,49,78,177,+
98,74,76,23,271,+
48,37,47,73,205,+
33,96,11,65,205,+
2,66,16,11,95,+
24,97,22,42,185,+
41,71,90,14,216,+
0,17,63,70,150,+
41,81,24,21,167,+
74,96,77,22,269,+
82,17,99,35,233,+
78,63,47,70,258,+
96,56,50,94,296,+
70,21,37,99,227,+
37,71,72,76,256,+
96,73,42,22,233,+
94,20,71,97,282,+
45,16,59,63,183,+
82,33,4,33,152,+
81,1,9,13,104,+
31,93,56,67,247,+
41,15,89,85,230,+
10,14,74,15,113,+
62,88,81,97,328,+
70,86,68,62,286,+
85,99,58,42,284,+
92,50,72,15,229,+
43,14,74,74,205,+
1,52,38,75,166,+
54,9,78,53,194,+
37,56,43,62,198,+
31,38,70,72,211,+
25,86,97,48,256,+
24,99,44,41,208,+
29,75,20,99,223,+
92,33,99,80,304,+
67,72,10,5,154,+
44,18,82,23,167,+
16,39,28,17,100,+
96,24,19,62,201,+
48,34,65,78,225,+
57,30,28,83,198,+
88,51,98,72,309,+
52,36,31,94,213,+
91,22,1,10,124,+
68,3,27,25,123,+
33,76,34,96,239,+
18,27,93,95,233,+
27,46,21,53,147,+
29,14,8,64,115,+
48,17,26,12,103,+
67,22,15,67,171,+
77,40,50,53,220,+
60,9,68,1,138,+
9,27,13,6,55,+
65,69,74,60,268,+
73,20,82,63,238,+
16,63,61,84,224,+
65,39,89,83,276,+
3,76,95,63,237,+
18,5,85,18,126,+
47,69,53,10,179,+
51,2,39,71,163,+
88,0,69,98,255,+
27,82,51,28,188,+
71,89,40,40,240,+
91,38,0,34,163,+
36,57,84,20,197,+
84,10,40,44,178,+
37,78,95,19,229,+
83,72,15,22,192,+
93,77,56,93,319,+
79,68,18,86,251,+
20,28,99,88,235,+
20,67,85,1,173,+
91,82,33,14,220,+
72,39,86,58,255,+
86,36,2,35,159,+
64,74,75,44,257,+
73,23,21,90,207,+
26,73,77,31,207,+
14,34,19,11,78,+
15,5,79,56,155,+
56,20,57,97,230,+
21,19,31,66,137,+
89,11,87,34,221,+
72,19,30,19,140,+
43,20,10,36,109,+
68,95,5,50,218,+
91,76,50,85,302,+
34,66,38,36,174,+
29,88,53,23,193,+
48,1,37,85,171,+
2,96,49,35,182,+
62,33,31,11,137,+
54,29,74,60,217,+
94,40,90,66,290,+
29,63,76,25,193,+
40,6,78,87,211,+
12,96,69,35,212,+
27,89,85,34,235,+
44,48,77,52,221,+
99,53,30,54,236,+
81,61,94,71,307,+
2,89,47,48,186,+
84,37,61,29,211,+
90,44,69,73,276,+
4,96,52,55,207,+
58,25,74,6,163,+
97,72,12,42,223,+
25,74,59,19,177,+
17,41,83,54,195,+
51,7,76,16,150,+
46,23,64,63,196,+
76,1,17,33,127,+
32,50,14,99,195,+
27,12,60,18,117,+
48,74,96,32,250,+
43,75,19,75,212,+
98,56,9,82,245,+
68,94,78,42,282,+
15,74,88,46,223,+
29,43,75,16,163,+
99,91,66,43,299,+
0,26,73,62,161,+
39,33,41,15,128,+
37,86,16,8,147,+
29,31,74,95,229,+
67,96,99,17,279,+
93,42,53,9,197,+
50,8,88,22,168,+
1,45,45,88,179,+
99,24,28,34,185,+
92,47,13,12,164,+
7,0,53,24,84,+
5,75,96,96,272,+
83,41,51,97,272,+
33,75,91,20,219,+
24,49,33,36,142,+
20,2,77,84,183,+
28,95,23,13,159,+
47,35,58,85,225,+
74,79,5,7,165,+
50,48,69,41,208,+
52,7,77,24,160,+
92,16,2,84,194,+
88,75,27,31,221,+
91,28,73,84,276,+
2,39,18,11,70,+
80,49,11,41,181,+
30,75,5,27,137,+
41,4,94,79,218,+
34,92,44,34,204,+
6,14,98,95,213,+
42,96,71,24,233,+
82,50,70,77,279,+
16,6,43,85,150,+
19,0,58,73,150,+
56,85,13,70,224,+
17,80,31,23,151,+
23,38,86,89,236,+
64,42,20,91,217,+
24,48,66,62,200,+
33,83,30,92,238,+
30,67,95,76,268,+
80,18,38,63,199,+
1,65,28,22,116,+
49,40,71,31,191,+
40,83,36,31,190,+
12,43,8,29,92,+
31,15,25,37,108,+
91,73,95,94,353,+
74,38,57,70,239,+
40,39,62,99,240,+
38,5,42,30,115,+
97,68,79,46,290,+
12,23,17,97,149,+
36,32,25,27,120,+
58,6,21,75,160,+
22,30,70,43,165,+
12,81,23,63,179,+
30,60,12,76,178,+
88,85,53,48,274,+
32,63,99,18,212,+
1,46,55,62,164,+
15,59,90,86,250,+
9,92,98,83,282,+
25,39,82,7,153,+
82,93,35,32,242,+
7,38,2,38,85,+
20,47,25,1,93,+
35,85,4,39,163,+
64,63,55,25,207,+
94,99,12,17,222,+
76,44,93,58,271,+
50,22,21,7,100,+
9,14,81,0,104,+
1,82,91,66,240,+
25,69,22,43,159,+
43,26,2,25,96,+
65,20,61,26,172,+
53,51,97,59,260,+
65,91,94,15,265,+
8,71,44,88,211,+
3,89,39,95,226,+
83,57,11,3,154,+
86,78,75,10,249,+
11,29,94,66,200,+
68,62,75,10,215,+
78,90,26,85,279,+
16,79,3,64,162,+
83,91,42,37,253,+
70,36,86,92,284,+
88,69,55,41,253,+
32,86,68,66,252,+
81,31,80,40,232,+
97,87,22,90,296,+
46,55,80,41,222,+
97,47,9,97,250,+
93,67,72,81,313,+
70,11,95,8,184,+
71,95,96,15,277,+
60,24,96,13,193,+
72,50,33,75,230,+
56,99,16,1,172,+
69,53,53,94,269,+
49,60,67,42,218,+
87,61,37,6,191,+
22,87,64,79,252,+
18,67,87,82,254,+
34,69,59,18,180,+
80,35,44,90,249,+
67,8,90,87,252,+
37,53,13,46,149,+
52,15,37,72,176,+
55,7,22,91,175,+
22,36,54,0,112,+
48,42,51,39,180,+
59,54,83,58,254,+
85,13,91,47,236,+
27,80,18,22,147,+
87,96,13,57,253,+
82,48,44,4,178,+
55,40,14,92,201,+
62,28,31,67,188,+
58,34,15,41,148,+
80,30,18,3,131,+
19,60,42,87,208,+
13,69,98,40,220,+
68,20,37,4,129,+
68,68,37,40,213,+
66,50,8,88,212,+
14,20,58,88,180,+
91,32,78,68,269,+
5,81,24,89,199,+
74,98,24,25,221,+
46,77,8,93,224,+
83,8,12,53,156,+
5,4,2,75,86,+
79,52,80,26,237,+
10,89,5,89,193,+
0,81,88,52,221,+
51,4,24,90,169,+
93,56,77,14,240,+
48,91,40,68,247,+
77,45,66,3,191,+
77,16,91,8,192,+
53,25,9,61,148,+
40,32,78,0,150,+
65,85,10,77,237,+
55,29,16,91,191,+
97,6,91,8,202,+
53,79,51,68,251,+
91,25,98,54,268,+
46,77,55,86,264,+
21,40,99,1,161,+
71,69,25,95,260,+
48,32,22,27,129,+
36,2,31,43,112,+
93,38,22,37,190,+
60,77,52,74,263,+
37,60,18,53,168,+
79,98,90,51,318,+
45,49,7,71,172,+
8,79,79,25,191,+
63,46,82,68,259,+
46,33,28,92,199,+
72,22,52,15,161,+
95,53,8,2,158,+
24,43,31,85,183,+
36,46,42,26,150,+
41,21,48,62,172,+
28,33,41,49,151,+
21,81,63,1,166,+
24,98,49,59,230,+
48,63,75,49,235,+
30,13,98,92,233,+
80,42,1,56,179,+
71,29,64,97,261,+
72,18,20,91,201,+
39,50,65,90,244,+
82,84,45,69,280,+
13,84,42,5,144,+
76,19,94,2,191,+
94,59,62,83,298,+
2,48,51,9,110,+
48,83,21,31,183,+
61,49,72,25,207,+
75,71,24,95,265,+
12,93,28,70,203,+
64,55,41,2,162,+
99,22,44,11,176,+
10,42,70,91,213,+
38,94,32,46,210,+
87,86,83,96,352,+
85,3,98,49,235,+
9,7,35,64,115,+
54,90,25,92,261,+
36,7,43,62,148,+
34,35,1,1,71,+
80,26,84,70,260,+
25,7,64,3,99,+
73,47,4,53,177,+
70,34,31,16,151,+
64,3,36,5,108,+
85,7,70,27,189,+
61,4,0,82,147,+
16,53,27,16,112,+
96,82,51,53,282,+
27,67,9,27,130,+
27,47,18,75,167,+
53,59,3,20,135,+
8,30,73,31,142,+
9,93,74,69,245,+
13,82,53,47,195,+
69,31,77,63,240,+
47,83,67,55,252,+
90,43,55,6,194,+
43,92,38,62,235,+
89,33,47,75,244,+
36,16,30,78,160,+
67,0,3,52,122,+
29,80,74,25,208,+
24,31,52,61,168,+
25,12,75,12,124,+
59,42,81,25,207,+
87,29,74,21,211,+
94,7,62,64,227,+
41,71,59,75,246,+
8,41,47,12,108,+
57,94,43,49,243,+
26,46,33,31,136,+
18,94,7,34,153,+
46,17,35,88,186,+
60,22,50,74,206,+
77,56,17,55,205,+
36,1,1,94,132,+
3,99,40,37,179,+
31,18,48,32,129,+
29,76,47,16,168,+
59,19,76,84,238,+
31,38,5,92,166,+
59,50,99,33,241,+
46,43,91,5,185,+
84,72,77,69,302,+
4,18,67,86,175,+
80,83,20,24,207,+
97,96,91,41,325,+
4,16,69,41,130,+
8,70,1,91,170,+
17,10,60,34,121,+
8,48,9,37,102,+
69,19,33,73,194,+
98,44,86,28,256,+
48,81,81,33,243,+
56,98,17,74,245,+
21,58,46,31,156,+
34,42,75,92,243,+
9,75,36,89,209,+
69,89,79,49,286,+
59,81,33,99,272,+
23,45,69,65,202,+
16,20,66,94,196,+
30,93,14,50,187,+
23,96,98,31,248,+
41,43,80,57,221,+
84,13,13,6,116,+
20,24,27,72,143,+
15,28,69,49,161,+
17,35,37,29,118,+
88,68,52,76,284,+
96,49,97,71,313,+
46,40,23,56,165,+
25,27,65,87,204,+
75,18,95,81,269,+
1,48,35,30,114,+
2,51,29,12,94,+
34,59,68,35,196,+
31,8,64,1,104,+
74,31,5,80,190,+
95,19,87,57,258,+
95,89,64,36,284,+
45,30,82,86,243,+
19,22,98,72,211,+
41,72,31,41,185,+
53,91,25,5,174,+
92,50,61,86,289,+
27,73,90,30,220,+
16,45,15,20,96,+
23,48,26,3,100,+
71,95,87,75,328,+
87,77,37,56,257,+
13,8,75,21,117,+
43,12,32,3,90,+
8,47,87,78,220,+
2,56,57,48,163,+
15,17,40,57,129,+
18,98,10,11,137,+
17,7,95,57,176,+
63,39,9,21,132,+
19,84,23,52,178,+
2,53,46,45,146,+
90,36,78,17,221,+
43,69,83,67,262,+
90,81,37,25,233,+
57,51,75,76,259,+
36,90,62,98,286,+
7,96,85,8,196,+
2,90,18,89,199,+
44,32,88,81,245,+
6,87,12,14,119,+
79,36,60,74,249,+
46,2,95,21,164,+
1,56,27,73,157,+
77,95,24,56,252,+
31,84,61,97,273,+
85,16,2,19,122,+
92,56,10,90,248,+
73,9,76,97,255,+
71,3,12,59,145,+
30,36,46,2,114,+
20,12,30,97,159,+
16,32,88,22,158,+
85,67,26,78,256,+
83,25,7,98,213,+
35,95,48,34,212,+
96,5,47,27,175,+
1,4,81,32,118,+
22,65,76,84,247,+
11,39,38,69,157,+
26,82,75,97,280,+
30,94,54,62,240,+
32,35,37,67,171,+
12,59,32,36,139,+
79,46,26,5,156,+
45,80,67,26,218,+
67,67,72,26,232,+
45,47,93,56,241,+
22,47,95,23,187,+
11,89,42,59,201,+
77,49,12,3,141,+
43,52,93,61,249,+
51,6,56,42,155,+
23,39,96,35,193,+
47,0,5,86,138,+
61,71,69,31,232,+
21,3,55,25,104,+
5,3,67,50,125,+
18,28,80,51,177,+
83,93,72,43,291,+
4,60,92,20,176,+
84,76,14,12,186,+
83,77,86,76,322,+
49,29,97,39,214,+
61,19,58,10,148,+
80,63,25,70,238,+
50,3,61,55,169,+
11,61,38,92,202,+
84,52,89,76,301,+
65,19,96,51,231,+
58,18,13,1,90,+
57,84,74,52,267,+
24,32,38,15,109,+
39,96,23,81,239,+
4,17,95,6,122,+
31,79,99,67,276,+
9,84,51,71,215,+
56,84,93,82,315,+
61,86,54,58,259,+
39,20,35,43,137,+
44,51,44,54,193,+
49,5,33,50,137,+
88,26,4,74,192,+
30,87,71,34,222,+
60,81,69,17,227,+
6,47,65,96,214,+
85,40,43,89,257,+
73,49,81,97,300,+
48,70,39,68,225,+
10,9,38,65,122,+
72,70,52,72,266,+
84,32,77,50,243,+
28,62,99,56,245,+
28,95,74,53,250,+
85,63,50,98,296,+
70,72,99,5,246,+
96,21,45,6,168,+
92,87,31,64,274,+
49,3,18,45,115,+
42,42,77,8,169,+
28,97,56,54,235,+
71,30,92,26,219,+
15,10,25,37,87,+
6,4,77,63,150,+
80,78,63,91,312,+
96,65,90,70,321,+
6,50,6,55,117,+
92,18,77,7,194,+
50,84,36,91,261,+
72,58,6,21,157,+
17,97,17,50,181,+
62,38,73,6,179,+
91,43,25,93,252,+
97,39,45,83,264,+
39,2,97,3,141,+
23,84,83,26,216,+
9,36,92,53,190,+
24,64,87,28,203,+
58,93,46,3,200,+
49,76,79,17,221,+
73,18,32,53,176,+
36,69,37,24,166,+
93,46,38,87,264,+
71,10,90,87,258,+
43,0,50,43,136,+
42,27,79,8,156,+
37,52,96,17,202,+
43,85,57,72,257,+
37,5,61,75,178,+
73,12,85,36,206,+
38,73,9,3,123,+
96,15,15,70,196,+
37,36,86,18,177,+
56,80,83,20,239,+
45,73,53,36,207,+
32,22,97,71,222,+
94,17,4,90,205,+
27,94,15,68,204,+
44,68,1,92,205,+
38,87,14,84,223,+
49,55,83,9,196,+
7,72,30,37,146,+
42,82,33,35,192,+
40,32,74,18,164,+
80,43,34,46,203,+
64,32,52,24,172,+
64,13,65,65,207,+
59,83,1,63,206,+
94,33,95,73,295,+
7,50,80,32,169,+
87,34,80,19,220,+
91,53,59,25,228,+
64,19,86,56,225,+
75,18,65,9,167,+
23,44,82,30,179,+
82,82,6,21,191,+
6,56,17,50,129,+
16,48,59,56,179,+
43,32,4,73,152,+
29,15,16,95,155,+
3,24,45,30,102,+
40,49,16,99,204,+
81,5,78,20,184,+
16,14,98,93,221,+
55,73,31,48,207,+
52,7,11,0,70,+
45,74,47,2,168,+
89,44,43,63,239,+
62,20,9,64,155,+
58,14,37,24,133,+
30,74,24,91,219,+
3,93,11,2,109,+
3,31,15,10,59,+
85,49,72,19,225,+
42,45,21,28,136,+
21,65,39,31,156,+
22,68,45,60,195,+
40,56,19,95,210,+
32,58,68,96,254,+
89,18,70,15,192,+
3,95,15,73,186,+
97,75,4,55,231,+
45,41,40,23,149,+
7,82,67,28,184,+
65,40,17,50,172,+
49,40,61,21,171,+
63,25,75,97,260,+
4,31,17,49,101,+
49,27,43,95,214,+
88,33,55,75,251,+
55,18,19,1,93,+
8,3,17,73,101,+
13,54,65,80,212,+
0,94,34,76,204,+
54,28,44,83,209,+
87,41,33,99,260,+
69,87,78,67,301,+
95,63,59,97,314,+
17,41,55,32,145,+
78,29,18,37,162,+
50,93,57,47,247,+
32,7,11,91,141,+
9,4,30,3,46,+
94,5,56,7,162,+
97,85,85,65,332,+
22,90,95,70,277,+
15,37,76,1,129,+
83,36,39,13,171,+
86,47,89,13,235,+
88,85,53,72,298,+
0,40,11,5,56,+
50,13,22,16,101,+
61,45,34,0,140,+
98,9,4,0,111,+
14,23,73,59,169,+
94,80,58,19,251,+
43,26,68,85,222,+
46,15,50,23,134,+
19,94,33,91,237,+
38,63,83,20,204,+
16,33,50,70,169,+
13,11,91,63,178,+
36,24,79,86,225,+
18,39,4,39,100,+
64,14,7,97,182,+
30,90,3,77,200,+
25,67,53,4,149,+
26,71,44,35,176,+
69,28,60,61,218,+
54,86,35,4,179,+
56,41,91,75,263,+
98,50,29,26,203,+
59,88,77,90,314,+
45,74,7,43,169,+
99,33,33,6,171,+
24,49,81,59,213,+
86,13,54,29,182,+
57,10,30,23,120,+
23,40,35,87,185,+
37,3,59,1,100,+
25,17,14,81,137,+
50,5,17,62,134,+
55,89,85,82,311,+
44,5,5,87,141,+
37,48,83,21,189,+
37,85,43,88,253,+
70,0,44,31,145,+
65,92,21,5,183,+
19,6,67,46,138,+
65,26,20,67,178,+
17,34,73,81,205,+
38,26,66,89,219,+
74,93,98,3,268,+
83,44,93,34,254,+
69,15,1,84,169,+
25,62,59,89,235,+
39,46,51,82,218,+
21,68,20,8,117,+
95,44,35,52,226,+
4,52,80,14,150,+
87,48,79,78,292,+
68,72,12,12,164,+
85,6,19,59,169,+
50,41,75,11,177,+
28,89,45,39,201,+
83,7,9,67,166,+
26,18,58,85,187,+
93,98,53,3,247,+
28,4,47,58,137,+
82,66,60,66,274,+
67,95,38,28,228,+
41,8,94,16,159,+
75,80,28,46,229,+
24,43,25,50,142,+
3,21,43,2,69,+
23,82,62,50,217,+
41,25,63,11,140,+
16,52,53,37,158,+
90,44,97,91,322,+
49,63,72,41,225,+
62,66,80,15,223,+
98,11,46,19,174,+
41,71,85,83,280,+
5,88,96,97,286,+
73,16,10,90,189,+
47,53,53,25,178,+
83,65,36,45,229,+
92,58,78,53,281,+
3,51,89,63,206,+
72,86,0,56,214,+
36,61,66,72,235,+
25,51,25,53,154,+
6,66,56,13,141,+
61,38,62,20,181,+
4,68,11,88,171,+
83,2,23,67,175,+
55,88,6,94,243,+
53,82,77,99,311,+
19,35,43,20,117,+
35,40,52,97,224,+
68,20,24,66,178,+
94,32,76,2,204,+
39,95,95,55,284,+
25,86,65,85,261,+
36,63,62,87,248,+
68,24,11,95,198,+
38,78,81,1,198,+
99,32,37,2,170,+
21,76,10,21,128,+
1,46,83,98,228,+
15,13,74,57,159,+
52,10,35,53,150,+
38,31,91,54,214,+
66,4,12,47,129,+
60,67,91,21,239,+
30,24,17,90,161,+
75,27,62,71,235,+
23,91,42,85,241,+
47,30,90,86,253,+
38,45,49,56,188,+
23,5,61,61,150,+
77,84,24,15,200,+
65,77,52,96,290,+
79,54,17,86,236,+
10,33,91,74,208,+
23,99,62,90,274,+
16,16,7,55,94,+
82,33,75,12,202,+
36,57,55,7,155,+
46,78,85,59,268,+
45,67,19,53,184,+
89,59,81,5,234,+
98,71,63,52,284,+
57,22,99,7,185,+
1,51,41,61,154,+
9,73,35,57,174,+
50,9,6,17,82,+
1,86,52,8,147,+
52,78,35,83,248,+
54,41,73,74,242,+
27,78,78,95,278,+
22,55,4,50,131,+
7,27,44,11,89,+
35,60,6,19,120,+
80,83,60,46,269,+
8,70,95,46,219,+
59,3,46,66,174,+
39,29,60,40,168,+
77,53,40,89,259,+
38,6,34,94,172,+
13,40,5,45,103,+
15,12,92,80,199,+
57,77,27,3,164,+
16,26,98,92,232,+
55,84,8,64,211,+
2,79,35,25,141,+
98,25,87,59,269,+
5,20,8,52,85,+
23,9,61,73,166,+
68,26,89,30,213,+
48,96,66,28,238,+
99,34,83,10,226,+
8,51,29,78,166,+
92,28,89,90,299,+
81,30,66,71,248,+
91,59,77,30,257,+
26,61,68,24,179,+
67,70,80,56,273,+
48,60,22,81,211,+
95,65,22,75,257,+
76,38,1,81,196,+
28,88,48,23,187,+
12,92,8,97,209,+
4,67,4,82,157,+
38,43,85,53,219,+
16,52,38,94,200,+
16,94,2,36,148,+
87,71,8,34,200,+
56,35,37,6,134,+
22,1,87,22,132,+
83,69,81,48,281,+
29,52,39,74,194,+
92,67,78,14,251,+
93,6,61,95,255,+
62,73,15,48,198,+
43,58,92,75,268,+
61,96,81,9,247,+
22,96,58,30,206,+
10,65,33,24,132,+
43,92,97,75,307,+
66,11,20,1,98,+
68,15,5,74,162,+
56,43,50,92,241,+
39,39,15,41,134,+
13,89,91,43,236,+
91,22,26,80,219,+
21,93,56,1,171,+
45,38,30,3,116,+
42,41,12,86,181,+
35,66,64,99,264,+
6,0,21,48,75,+
15,70,17,76,178,+
25,24,37,35,121,+
75,35,91,1,202,+
45,42,39,20,146,+
75,76,62,91,304,+
63,18,66,42,189,+
73,13,11,1,98,+
16,37,4,14,71,+
41,45,80,12,178,+
92,37,89,42,260,+
14,26,77,15,132,+
2,66,31,81,180,+
51,63,60,47,221,+
13,6,70,10,99,+
81,50,74,15,220,+
0,9,26,18,53,+
10,27,84,60,181,+
2,69,12,28,111,+
61,16,60,27,164,+
51,38,65,30,184,+
3,77,76,98,254,+
82,55,49,41,227,+
21,27,89,78,215,+
14,77,21,88,200,+
13,62,89,60,224,+
22,12,44,67,145,+
83,22,85,63,253,+
54,57,14,50,175,+
58,17,40,1,116,+
48,70,36,88,242,+
94,61,46,30,231,+
2,62,84,45,193,+
26,51,89,27,193,+
39,56,69,76,240,+
44,61,34,88,227,+
84,64,12,57,217,+
4,62,57,22,145,+
39,46,27,2,114,+
14,59,99,3,175,+
54,52,26,19,151,+
31,20,74,47,172,+
97,23,25,11,156,+
2,93,94,18,207,+
83,73,50,39,245,+
45,82,77,70,274,+
0,65,96,49,210,+
45,90,79,88,302,+
19,58,81,36,194,+
60,15,30,76,181,+
18,32,44,5,99,+
71,52,52,11,186,+
71,30,6,79,186,+
22,51,89,65,227,+
36,87,90,81,294,+
64,27,13,2,106,+
49,4,72,92,217,+
13,39,97,4,153,+
79,58,54,25,216,+
42,82,14,26,164,+
61,58,13,13,145,+
6,16,56,9,87,+
63,96,51,15,225,+
21,76,17,64,178,+
4,58,35,54,151,+
73,21,71,35,200,+
2,46,27,30,105,+
26,15,75,1,117,+
31,97,44,91,263,+
8,45,3,26,82,+
10,95,15,50,170,+
57,16,72,77,222,+
16,38,31,1,86,+
66,90,38,41,235,+
45,74,51,51,221,+
44,99,3,23,169,+
54,97,44,23,218,+
68,76,6,23,173,+
11,44,99,0,154,+
54,34,68,47,203,+
36,70,68,38,212,+
23,15,7,94,139,+
81,18,61,58,218,+
19,66,49,63,197,+
49,58,46,6,159,+
24,83,25,42,174,+
93,75,71,21,260,+
22,85,2,77,186,+
87,2,65,87,241,+
29,58,85,54,226,+
78,75,39,86,278,+
87,66,35,98,286,+
43,21,60,7,131,+
22,19,13,67,121,+
64,99,18,23,204,+
38,20,90,58,206,+
22,70,28,14,134,+
81,46,48,10,185,+
45,78,61,90,274,+
63,94,76,26,259,+
67,64,86,12,229,+
5,41,40,25,111,+
44,72,19,63,198,+
83,94,59,79,315,+
74,14,40,38,166,+
70,53,37,69,229,+
9,57,58,4,128,+
8,83,26,54,171,+
23,37,62,95,217,+
49,55,2,82,188,+
3,42,25,70,140,+
57,23,28,48,156,+
34,59,96,10,199,+
55,83,97,54,289,+
1,82,30,78,191,+
18,86,69,14,187,+
50,69,11,55,185,+
12,6,18,37,73,+
94,91,45,15,245,+
23,33,49,22,127,+
31,1,28,30,90,+
84,95,26,11,216,+
90,72,99,17,278,+
64,48,46,17,175,+
84,57,37,59,237,+
19,81,30,74,204,+
17,99,22,29,167,+
37,59,64,18,178,+
36,43,75,72,226,+
11,24,98,31,164,+
49,28,11,26,114,+
88,43,50,81,262,+
80,87,75,15,257,+
11,55,35,30,131,+
1,94,19,9,123,+
69,0,55,73,197,+
80,82,11,65,238,+
10,67,77,53,207,+
16,20,19,9,64,+
21,56,29,76,182,+
43,60,81,48,232,+
95,76,42,20,233,+
95,88,72,96,351,+
2,19,3,22,46,+
14,85,2,59,160,+
65,42,65,44,216,+
60,99,63,61,283,+
91,74,54,73,292,+
14,17,40,51,122,+
76,23,61,91,251,+
63,25,36,27,151,+
58,48,61,83,250,+
57,41,81,55,234,+
56,35,72,31,194,+
78,23,93,12,206,+
31,27,47,53,158,+
89,17,75,42,223,+
3,88,45,74,210,+
21,26,89,86,222,+
76,90,99,35,300,+
67,59,39,98,263,+
90,23,62,20,195,+
57,74,97,99,327,+
22,86,86,54,248,+
95,1,88,18,202,+
4,73,72,59,208,+
38,68,56,74,236,+
19,23,16,70,128,+
39,10,52,66,167,+
61,9,79,51,200,+
76,58,21,92,247,+
70,81,46,61,258,+
8,68,47,47,170,+
80,32,3,5,120,+
60,9,97,10,176,+
53,27,23,78,181,+
21,90,64,96,271,+
9,32,78,22,141,+
39,8,27,25,99,+
58,81,81,40,260,+
46,2,82,82,212,+
87,5,17,3,112,+
29,11,29,81,150,+
18,66,46,95,225,+
29,33,10,5,77,+
3,0,98,53,154,+
48,58,58,3,167,+
74,24,46,53,197,+
11,26,11,77,125,+
70,6,0,51,127,+
34,68,9,60,171,+
37,34,10,21,102,+
97,60,10,99,266,+
99,75,95,46,315,+
32,73,48,82,235,+
40,70,92,85,287,+
39,24,11,64,138,+
12,4,83,14,113,+
28,31,17,59,135,+
12,60,74,42,188,+
25,38,36,58,157,+
78,57,31,39,205,+
69,96,73,68,306,+
32,81,47,23,183,+
69,84,54,76,283,+
99,85,44,53,281,+
92,59,57,79,287,+
5,16,49,97,167,+
56,75,45,44,220,+
85,51,7,62,205,+
45,82,62,41,230,+
93,26,19,86,224,+
78,44,79,34,235,+
59,24,6,15,104,+
73,25,46,70,214,+
38,65,50,18,171,+
9,46,36,39,130,+
66,73,77,37,253,+
21,48,82,19,170,+
70,21,74,15,180,+
33,65,26,14,138,+
15,98,22,39,174,+
95,25,54,46,220,+
10,79,32,54,175,+
13,82,88,30,213,+
74,26,86,8,194,+
75,33,37,47,192,+
51,89,66,17,223,+
40,1,77,82,200,+
42,87,31,78,238,+
72,34,50,34,190,+
0,75,40,97,212,+
53,49,24,90,216,+
1,21,43,11,76,+
73,52,50,13,188,+
19,84,36,62,201,+
6,31,41,11,89,+
55,33,94,75,257,+
25,14,65,65,169,+
39,74,85,62,260,+
91,63,55,37,246,+
82,18,76,82,258,+
3,74,4,98,179,+
85,27,65,30,207,+
9,90,27,8,134,+
3,30,91,5,129,+
98,60,24,0,182,+
79,87,29,74,269,+
17,31,5,73,126,+
10,36,69,27,142,+
25,91,80,6,202,+
50,22,90,53,215,+
51,32,58,82,223,+
4,86,67,95,252,+
0,14,66,22,102,+
87,96,29,33,245,+
10,78,80,27,195,+
84,64,58,7,213,+
46,27,70,87,230,+
33,22,7,42,104,+
86,68,68,13,235,+
52,36,94,74,256,+
87,66,20,45,218,+
84,75,47,0,206,+
21,8,8,50,87,+
98,16,96,7,217,+
1,84,75,50,210,+
5,45,43,20,113,+
10,21,39,20,90,+
70,79,87,52,288,+
20,28,14,53,115,+
80,57,1,3,141,+
22,65,52,99,238,+
36,14,73,66,189,+
15,0,60,39,114,+
39,41,80,96,256,+
26,47,82,56,211,+
84,62,89,39,274,+
26,78,77,26,207,+
89,63,35,45,232,+
87,21,14,92,214,+
96,89,47,69,301,+
73,36,85,17,211,+
7,70,56,10,143,+
17,87,78,87,269,+
61,24,14,79,178,+
70,44,14,62,190,+
55,30,50,45,180,+
6,96,96,89,287,+
95,52,25,53,225,+
78,59,5,72,214,+
44,97,31,83,255,+
96,91,10,20,217,+
40,8,20,27,95,+
18,53,64,91,226,+
18,89,53,44,204,+
6,5,76,0,87,+
50,80,84,19,233,+
33,52,19,54,158,+
58,5,58,8,129,+
91,82,38,69,280,+
12,51,70,38,171,+
4,87,65,53,209,+
50,98,47,51,246,+
14,21,49,18,102,+
34,47,70,32,183,+
77,52,56,31,216,+
67,55,92,21,235,+
6,15,4,33,58,+
6,58,11,41,116,+
51,29,39,49,168,+
91,23,51,71,236,+
21,14,64,21,120,+
42,97,47,71,257,+
75,42,71,71,259,+
12,60,21,69,162,+
9,28,59,15,111,+
43,55,90,77,265,+
69,58,26,1,154,+
28,57,74,61,220,+
25,77,50,79,231,+
34,7,33,2,76,+
70,2,27,89,188,+
27,15,32,51,125,+
82,61,88,10,241,+
83,87,29,73,272,+
7,51,82,86,226,+
9,83,17,83,192,+
78,28,79,97,282,+
63,3,5,67,138,+
88,89,44,40,261,+
4,68,53,90,215,+
22,94,39,6,161,+
9,97,29,87,222,+
94,98,51,91,334,+
61,46,62,46,215,+
88,96,32,75,291,+
18,27,21,83,149,+
98,12,37,53,200,+
13,83,7,23,126,+
42,79,98,66,285,+
12,12,12,64,100,+
7,97,79,54,237,+
5,64,14,45,128,+
11,59,43,11,124,+
67,40,79,98,284,+
40,64,47,10,161,+
20,8,32,79,139,+
1,46,55,36,138,+
31,92,52,45,220,+
61,61,92,57,271,+
24,13,69,36,142,+
8,83,21,42,154,+
0,52,81,80,213,+
73,32,50,3,158,+
72,12,25,83,192,+
14,45,65,51,175,+
42,6,38,17,103,+
13,4,70,52,139,+
39,63,70,31,203,+
34,4,40,50,128,+
89,15,71,86,261,+
7,16,8,47,78,+
35,41,29,55,160,+
57,61,12,52,182,+
63,31,60,46,200,+
31,94,18,15,158,+
39,43,54,67,203,+
45,72,24,46,187,+
12,66,84,31,193,+
75,89,55,13,232,+
25,23,61,12,121,+
82,48,48,49,227,+
60,90,88,64,302,+
72,56,60,43,231,+
8,41,63,12,124,+
89,59,10,96,254,+
54,34,36,11,135,+
30,58,65,80,233,+
18,18,44,80,160,+
66,18,24,29,137,+
5,87,62,88,242,+
30,91,38,41,200,+
51,67,43,99,260,+
52,48,10,70,180,+
39,31,81,68,219,+
61,52,69,99,281,+
13,11,38,54,116,+
77,57,99,85,318,+
50,17,2,89,158,+
77,37,80,19,213,+
17,46,50,68,181,+
85,88,13,91,277,+
33,34,84,37,188,+
91,93,97,73,354,+
5,74,50,59,188,+
49,52,59,20,180,+
31,57,87,22,197,+
5,53,79,18,155,+
54,17,87,3,161,+
56,7,55,26,144,+
90,38,50,64,242,+
95,92,78,91,356,+
33,54,58,27,172,+
55,8,16,88,167,+
82,66,88,91,327,+
49,32,98,90,269,+
35,7,97,55,194,+
8,57,86,80,231,+
69,55,74,88,286,+
99,87,40,41,267,+
47,23,28,9,107,+
23,37,36,90,186,+
2,10,61,67,140,+
99,62,68,86,315,+
97,2,93,67,259,+
61,35,98,53,247,+
29,67,15,54,165,+
15,20,52,59,146,+
31,41,44,56,172,+
14,94,21,30,159,+
23,96,44,25,188,+
26,72,59,87,244,+
52,89,57,59,257,+
23,84,32,75,214,+
40,37,21,88,186,+
70,47,20,45,182,+
6,65,43,29,143,+
21,38,3,78,140,+
81,15,14,62,172,+
97,78,71,9,255,+
86,76,82,9,253,+
14,60,52,6,132,+
74,60,41,13,188,+
63,69,67,41,240,+
76,75,76,81,308,+
24,43,93,71,231,+
67,10,76,42,195,+
60,59,11,76,206,+
15,4,35,8,62,+
34,86,18,13,151,+
75,60,57,45,237,+
12,74,81,98,265,+
88,71,52,85,296,+
91,32,42,55,220,+
32,64,75,60,231,+
84,64,16,89,253,+
6,5,79,43,133,+
36,76,88,67,267,+
43,23,90,97,253,+
57,90,79,30,256,+
75,70,15,24,184,+
84,1,90,48,223,+
8,22,90,79,199,+
23,38,32,55,148,+
74,70,56,13,213,+
56,9,6,63,134,+
39,67,9,75,190,+
49,26,9,20,104,+
79,4,5,80,168,+
83,86,62,81,312,+
21,41,14,3,79,+
47,87,97,51,282,+
55,55,99,31,240,+
75,95,77,63,310,+
83,58,48,90,279,+
93,18,93,37,241,+
4,18,2,52,76,+
99,46,5,35,185,+
11,21,31,12,75,+
15,35,74,49,173,+
12,13,46,54,125,+
67,46,89,16,218,+
79,62,68,35,244,+
69,31,83,85,268,+
88,52,64,85,289,+
72,33,94,99,298,+
21,90,51,76,238,+
18,19,10,72,119,+
98,51,75,29,253,+
30,12,91,81,214,+
70,31,89,17,207,+
67,18,48,60,193,+
71,83,72,35,261,+
77,54,60,25,216,+
5,61,10,95,171,+
62,61,19,90,232,+
87,23,28,77,215,+
29,47,74,72,222,+
67,14,34,60,175,+
36,1,90,92,219,+
13,23,79,33,148,+
9,81,20,81,191,+
0,78,7,42,127,+
82,2,43,52,179,+
27,54,22,49,152,+
85,80,60,69,294,+
4,93,48,87,232,+
98,9,68,16,191,+
59,79,21,44,203,+
61,64,50,84,259,+
25,65,34,62,186,+
62,83,51,36,232,+
41,14,73,49,177,+
93,64,84,24,265,+
45,95,8,14,162,+
37,76,49,28,190,+
14,53,23,82,172,+
35,91,44,33,203,+
39,36,89,88,252,+
58,7,68,82,215,+
31,41,3,28,103,+
52,62,61,38,213,+
43,8,60,25,136,+
23,72,94,1,190,+
12,83,41,81,217,+
93,78,77,55,303,+
44,79,63,44,230,+
21,45,54,56,176,+
78,38,6,19,141,+
79,16,23,58,176,+
41,91,34,29,195,+
34,24,99,13,170,+
73,38,23,55,189,+
23,74,25,10,132,+
93,66,67,58,284,+
99,44,72,84,299,+
63,54,71,77,265,+
39,41,16,88,184,+
74,76,21,94,265,+
67,96,88,84,335,+
92,21,95,19,227,+
53,31,47,60,191,+
2,76,19,53,150,+
86,14,48,70,218,+
19,49,53,67,188,+
61,67,47,59,234,+
20,50,23,78,171,+
67,72,89,49,277,+
65,58,43,73,239,+
92,32,73,26,223,+
82,34,29,3,148,+
52,15,54,84,205,+
14,70,38,23,145,+
82,69,3,95,249,+
45,94,85,77,301,+
51,40,8,36,135,+
33,96,33,37,199,+
25,8,92,27,152,+
32,59,70,69,230,+
55,36,22,99,212,+
80,58,18,24,180,+
97,39,54,14,204,+
62,3,32,79,176,+
90,92,75,53,310,+
45,72,72,72,261,+
39,55,84,13,191,+
33,65,88,46,232,+
27,79,49,0,155,+
75,56,80,97,308,+
47,39,60,86,232,+
57,60,5,47,169,+
52,7,0,27,86,+
51,41,3,34,129,+
78,77,6,33,194,+
66,25,60,87,238,+
39,87,17,47,190,+
91,86,49,37,263,+
29,13,22,96,160,+
42,89,43,2,176,+
89,67,97,44,297,+
89,18,0,91,198,+
37,71,78,80,266,+
79,31,7,47,164,+
0,42,29,2,73,+
36,61,81,83,261,+
59,2,13,57,131,+
75,54,63,17,209,+
64,2,70,69,205,+
64,3,98,68,233,+
99,25,29,16,169,+
66,83,65,85,299,+
18,79,64,19,180,+
70,22,84,51,227,+
52,92,53,55,252,+
10,38,48,63,159,+
17,47,20,84,168,+
69,5,53,85,212,+
65,1,60,34,160,+
58,90,26,2,176,+
82,14,40,94,230,+
4,64,56,35,159,+
76,20,54,98,248,+
8,30,58,97,193,+
44,31,60,28,163,+
16,2,62,17,97,+
19,24,37,16,96,+
14,77,24,27,142,+
95,15,32,76,218,+
50,67,33,84,234,+
16,26,95,97,234,+
69,74,48,31,222,+
97,6,54,45,202,+
82,32,56,77,247,+
75,83,97,71,326,+
60,17,85,81,243,+
50,52,60,38,200,+
66,60,41,59,226,+
8,70,31,64,173,+
61,17,66,84,228,+
14,78,66,49,207,+
81,80,77,73,311,+
89,70,22,38,219,+
60,42,5,5,112,+
28,28,28,67,151,+
60,7,92,48,207,+
21,13,5,6,45,+
13,24,28,37,102,+
34,76,53,22,185,+
44,31,74,44,193,+
66,68,56,7,197,+
3,15,84,45,147,+
93,58,45,49,245,+
57,20,59,38,174,+
31,75,65,20,191,+
97,6,44,52,199,+
35,48,22,62,167,+
19,63,61,78,221,+
42,5,48,70,165,+
44,87,69,0,200,+
42,99,72,71,284,+
68,78,15,36,197,+
45,43,69,40,197,+
22,90,50,17,179,+
79,81,38,2,200,+
81,11,21,87,200,+
59,38,52,16,165,+
79,28,55,71,233,+
75,77,27,59,238,+
14,18,35,12,79,+
15,59,92,60,226,+
60,28,48,89,225,+
31,75,20,93,219,+
40,61,11,95,207,+
95,6,72,4,177,+
67,23,76,87,253,+
5,42,19,76,142,+
39,6,85,37,167,+
18,28,83,28,157,+
77,31,53,37,198,+
88,42,51,65,246,+
40,52,29,16,137,+
43,37,5,7,92,+
97,6,49,25,177,+
79,67,84,46,276,+
91,82,73,58,304,+
87,72,16,70,245,+
75,13,1,53,142,+
21,69,31,58,179,+
77,41,65,92,275,+
56,14,61,96,227,+
69,92,22,19,202,+
65,32,97,84,278,+
89,93,81,10,273,+
54,92,4,43,193,+
81,20,43,64,208,+
98,79,17,5,199,+
84,94,84,16,278,+
61,19,39,67,186,+
98,6,15,48,167,+
31,21,25,75,152,+
64,78,94,36,272,+
18,0,11,59,88,+
44,71,66,70,251,+
46,5,82,71,204,+
14,22,25,8,69,+
18,63,67,92,240,+
80,17,44,88,229,+
90,21,28,54,193,+
63,78,21,75,237,+
86,90,34,21,231,+
68,43,41,41,193,+
82,76,77,37,272,+
14,5,60,75,154,+
98,89,70,85,342,+
92,15,56,28,191,+
0,86,62,89,237,+
2,56,44,30,132,+
80,74,90,59,303,+
30,41,16,4,91,+
85,67,92,11,255,+
21,86,18,52,177,+
14,38,55,63,170,+
68,40,13,52,173,+
40,46,45,31,162,+
29,16,23,0,68,+
69,77,85,29,260,+
93,44,43,6,186,+
98,17,64,17,196,+
37,57,80,18,192,+
0,50,13,39,102,+
17,0,69,9,95,+
90,2,60,56,208,+
77,78,23,15,193,+
71,75,18,87,251,+
38,29,74,80,221,+
51,56,91,26,224,+
61,98,77,35,271,+
25,27,77,21,150,+
45,10,35,33,123,+
13,46,61,6,126,+
91,95,23,68,277,+
58,26,99,90,273,+
21,19,66,78,184,+
35,98,14,5,152,+
94,28,76,95,293,+
13,25,78,79,195,+
21,37,72,69,199,+
89,93,7,17,206,+
4,17,12,52,85,+
90,63,15,82,250,+
72,31,85,34,222,+
92,36,59,51,238,+
74,60,88,83,305,+
60,63,58,53,234,+
6,27,81,53,167,+
13,12,87,79,191,+
65,52,80,72,269,+
6,23,41,12,82,+
91,79,88,44,302,+
26,20,37,54,137,+
4,51,62,62,179,+
60,81,68,86,295,+
66,63,47,66,242,+
46,98,69,63,276,+
47,32,25,70,174,+
87,97,54,38,276,+
63,40,71,67,241,+
11,54,86,96,247,+
53,24,66,43,186,+
20,96,9,72,197,+
17,38,85,65,205,+
51,23,66,21,161,+
41,1,7,49,98,+
52,56,67,46,221,+
30,95,22,66,213,+
88,72,43,98,301,+
78,26,54,45,203,+
42,69,63,89,263,+
75,20,29,46,170,+
31,39,68,19,157,+
48,6,30,96,180,+
33,35,48,70,186,+
36,74,68,60,238,+
48,23,24,12,107,+
49,78,84,63,274,+
9,15,70,99,193,+
7,44,77,62,190,+
6,71,50,23,150,+
77,95,52,11,235,+
19,18,34,78,149,+
51,29,94,55,229,+
38,82,12,44,176,+
95,96,9,92,292,+
22,16,80,51,169,+
46,12,12,12,82,+
0,53,40,76,169,+
54,7,10,13,84,+
29,19,44,18,110,+
99,39,58,99,295,+
39,63,9,7,118,+
62,98,39,85,284,+
89,87,11,58,245,+
68,20,0,40,128,+
21,12,42,94,169,+
31,40,74,50,195,+
28,45,86,77,236,+
63,5,22,28,118,+
2,99,31,85,217,+
45,36,48,23,152,+
94,26,47,97,264,+
83,46,81,14,224,+
38,66,48,17,169,+
92,4,66,0,162,+
22,28,24,82,156,+
36,88,59,94,277,+
97,37,27,92,253,+
50,17,83,6,156,+
83,83,23,52,241,+
12,9,68,20,109,+
44,43,84,68,239,+
36,85,51,90,262,+
59,53,16,43,171,+
46,50,17,7,120,+
88,10,61,91,250,+
78,6,14,74,172,+
87,54,15,70,226,+
27,55,64,26,172,+
14,20,58,31,123,+
45,63,23,53,184,+
15,50,49,87,201,+
53,35,26,68,182,+
10,29,89,45,173,+
84,35,36,50,205,+
10,55,27,64,156,+
72,1,29,89,191,+
96,31,51,5,183,+
6,19,73,95,193,+
87,15,28,63,193,+
88,3,79,55,225,+
88,48,49,98,283,+
58,68,80,81,287,+
10,38,59,49,156,+
84,28,76,18,206,+
84,69,83,69,305,+
50,14,85,38,187,+
95,32,5,14,146,+
7,9,34,88,138,+
73,22,24,72,191,+
57,57,55,92,261,+
26,67,58,24,175,+
75,17,39,80,211,+
62,68,49,90,269,+
74,85,47,30,236,+
42,39,43,43,167,+
73,57,48,0,178,+
48,72,31,6,157,+
24,77,83,7,191,+
54,98,88,7,247,+
12,9,3,44,68,+
20,78,68,26,192,+
65,39,89,62,255,+
13,80,62,20,175,+
65,26,72,73,236,+
28,78,92,59,257,+
10,14,19,52,95,+
64,85,76,23,248,+
11,54,21,76,162,+
84,21,9,76,190,+
47,93,66,52,258,+
67,25,26,48,166,+
65,8,96,61,230,+
8,47,63,72,190,+
92,37,8,65,202,+
64,5,22,39,130,+
11,33,51,37,132,+
30,72,62,17,181,+
43,39,41,46,169,+
81,63,4,99,247,+
95,17,46,75,233,+
97,62,84,64,307,+
1,51,87,10,149,+
19,63,9,76,167,+
71,33,4,66,174,+
30,83,70,58,241,+
77,59,87,95,318,+
42,73,45,66,226,+
45,48,65,81,239,+
33,57,42,87,219,+
13,95,70,46,224,+
28,6,69,39,142,+
30,49,31,37,147,+
80,33,84,79,276,+
42,41,52,98,233,+
41,30,82,43,196,+
87,88,26,18,219,+
74,95,82,98,349,+
9,92,17,73,191,+
88,94,20,73,275,+
2,46,15,50,113,+
36,57,64,96,253,+
48,7,35,75,165,+
92,43,91,61,287,+
20,43,50,12,125,+
99,6,98,15,218,+
34,54,16,77,181,+
50,0,34,21,105,+
39,80,76,97,292,+
55,89,6,0,150,+
58,99,84,58,299,+
4,38,42,83,167,+
58,71,91,24,244,+
59,37,13,79,188,+
1,67,30,65,163,+
33,22,82,25,162,+
99,27,67,62,255,+
47,21,67,9,144,+
98,13,4,19,134,+
23,53,38,14,128,+
86,19,41,78,224,+
21,94,19,35,169,+
67,6,32,66,171,+
44,24,86,40,194,+
82,31,15,88,216,+
86,86,22,77,271,+
80,54,97,29,260,+
28,91,9,29,157,+
4,48,74,27,153,+
93,78,51,24,246,+
41,49,28,78,196,+
0,47,5,94,146,+
9,10,8,81,108,+
23,80,32,37,172,+
99,63,82,68,312,+
53,81,54,33,221,+
19,79,29,2,129,+
95,93,4,73,265,+
13,8,96,10,127,+
47,88,98,83,316,+
97,58,86,26,267,+
75,64,41,34,214,+
12,23,76,42,153,+
80,94,42,5,221,+
68,36,65,17,186,+
38,35,4,70,147,+
19,64,59,75,217,+
36,94,90,9,229,+
12,40,64,7,123,+
60,13,92,54,219,+
63,59,65,1,188,+
44,52,68,26,190,+
76,75,82,35,268,+
17,7,78,21,123,+
36,36,88,39,199,+
49,44,58,60,211,+
67,20,1,92,180,+
26,10,63,5,104,+
45,27,71,58,201,+
26,92,36,88,242,+
45,40,9,55,149,+
54,31,25,7,117,+
93,71,51,57,272,+
37,41,90,50,218,+
39,52,51,10,152,+
83,32,39,27,181,+
80,13,88,73,254,+
88,71,25,8,192,+
33,18,69,65,185,+
67,64,39,83,253,+
94,8,7,75,184,+
40,21,75,78,214,+
39,84,34,45,202,+
71,85,24,19,199,+
95,31,42,26,194,+
10,42,18,51,121,+
70,75,71,2,218,+
44,82,58,56,240,+
14,58,8,25,105,+
78,20,34,4,136,+
18,48,3,76,145,+
82,12,33,72,199,+
18,55,95,34,202,+
20,26,29,96,171,+
54,48,22,28,152,+
66,20,32,76,194,+
73,1,87,17,178,+
86,28,50,70,234,+
81,5,23,62,171,+
1,12,75,89,177,+
2,41,39,33,115,+
10,48,40,82,180,+
76,65,78,97,316,+
98,62,30,37,227,+
10,39,48,39,136,+
39,55,39,46,179,+
90,14,62,0,166,+
24,91,80,81,276,+
95,5,47,62,209,+
98,53,90,10,251,+
49,35,21,58,163,+
30,90,51,5,176,+
93,34,64,47,238,+
44,62,8,41,155,+
23,93,92,96,304,+
65,87,34,78,264,+
8,46,45,63,162,+
9,40,16,27,92,+
34,31,23,98,186,+
73,81,15,4,173,+
96,34,55,50,235,+
73,68,12,29,182,+
34,86,47,5,172,+
67,32,66,85,250,+
99,60,68,48,275,+
51,12,80,8,151,+
8,44,87,7,146,+
96,17,88,11,212,+
81,51,5,48,185,+
72,17,92,44,225,+
57,47,33,60,197,+
12,76,87,49,224,+
98,80,50,89,317,+
92,99,93,49,333,+
11,96,21,60,188,+
87,89,20,26,222,+
26,35,1,43,105,+
81,89,66,30,266,+
83,8,24,47,162,+
63,81,22,82,248,+
10,83,5,8,106,+
68,3,69,64,204,+
91,39,32,48,210,+
73,13,1,10,97,+
17,3,30,79,129,+
76,99,43,1,219,+
48,13,65,87,213,+
52,73,8,60,193,+
16,88,99,1,204,+
80,16,72,5,173,+
53,34,81,48,216,+
24,44,15,10,93,+
64,79,29,98,270,+
36,15,56,83,190,+
52,82,78,75,287,+
52,71,0,99,222,+
15,89,90,53,247,+
35,24,87,47,193,+
44,88,93,59,284,+
74,83,73,44,274,+
59,11,6,5,81,+
36,13,47,29,125,+
52,97,7,16,172,+
21,95,57,19,192,+
46,54,59,31,190,+
70,23,26,76,195,+
10,61,18,78,167,+
67,93,62,59,281,+
9,94,39,54,196,+
5,0,35,52,92,+
75,65,8,31,179,+
3,43,77,32,155,+
17,11,12,8,48,+
66,85,58,99,308,+
80,84,78,30,272,+
94,22,99,75,290,+
22,5,6,99,132,+
32,22,33,87,174,+
6,83,59,63,211,+
69,95,75,38,277,+
31,52,3,70,156,+
77,56,87,6,226,+
80,25,71,65,241,+
27,30,55,27,139,+
83,90,54,95,322,+
48,9,51,86,194,+
3,21,48,63,135,+
72,70,78,93,313,+
86,13,66,25,190,+
97,39,14,78,228,+
78,73,83,9,243,+
96,91,27,34,248,+
12,89,60,32,193,+
11,12,48,15,86,+
3,9,1,71,84,+
70,84,34,56,244,+
87,33,17,99,236,+
17,4,36,96,153,+
64,63,15,14,156,+
65,74,78,5,222,+
32,43,47,99,221,+
71,34,63,21,189,+
80,26,85,81,272,+
31,55,62,5,153,+
42,38,76,13,169,+
65,12,66,78,221,+
88,43,19,95,245,+
70,70,95,68,303,+
37,96,20,32,185,+
4,88,10,69,171,+
11,44,89,58,202,+
92,34,90,36,252,+
94,54,1,11,160,+
69,5,21,11,106,+
57,50,51,80,238,+
70,58,10,93,231,+
24,49,46,2,121,+
27,68,71,73,239,+
40,94,82,3,219,+
57,68,30,15,170,+
23,79,12,49,163,+
37,68,10,85,200,+
69,57,60,33,219,+
17,49,76,99,241,+
74,10,14,28,126,+
84,51,72,64,271,+
45,6,65,55,171,+
95,43,3,23,164,+
97,62,57,86,302,+
80,62,55,17,214,+
69,57,80,63,269,+
98,68,2,39,207,+
97,90,69,71,327,+
28,24,91,82,225,+
76,55,12,18,161,+
7,58,85,37,187,+
22,37,26,82,167,+
27,24,64,66,181,+
9,76,28,55,168,+
96,21,83,2,202,+
26,23,84,50,183,+
87,54,40,31,212,+
82,55,64,74,275,+
82,17,50,95,244,+
65,13,49,79,206,+
31,43,43,79,196,+
37,78,30,20,165,+
92,29,79,3,203,+
14,73,79,90,256,+
95,37,78,79,289,+
35,17,72,80,204,+
25,62,96,1,184,+
51,97,1,66,215,+
15,95,25,24,159,+
75,65,51,18,209,+
3,70,12,94,179,+
28,25,54,20,127,+
19,47,95,80,241,+
74,34,37,9,154,+
25,76,97,69,267,+
58,64,94,27,243,+
74,44,47,41,206,+
7,64,40,67,178,+
99,71,81,92,343,+
70,90,83,27,270,+
32,28,8,77,145,+
64,19,12,39,134,+
12,8,93,50,163,+
87,38,64,13,202,+
74,41,36,82,233,+
16,93,46,29,184,+
98,71,88,29,286,+
22,10,27,4,63,+
32,25,49,19,125,+
90,51,13,16,170,+
90,71,44,80,285,+
66,97,30,76,269,+
80,36,20,72,208,+
91,43,68,13,215,+
35,60,30,21,146,+
80,94,1,57,232,+
23,18,88,7,136,+
60,85,6,41,192,+
75,82,71,61,289,+
17,8,66,79,170,+
49,85,26,0,160,+
3,20,72,50,145,+
15,19,29,16,79,+
62,42,36,45,185,+
87,38,98,18,241,+
38,14,94,2,148,+
38,96,87,20,241,+
93,16,64,27,200,+
43,7,34,53,137,+
31,0,52,59,142,+
18,24,44,46,132,+
4,74,76,92,246,+
58,19,35,21,133,+
94,89,71,22,276,+
42,52,54,63,211,+
16,1,71,18,106,+
74,68,48,21,211,+
54,42,66,98,260,+
9,18,51,5,83,+
49,90,15,63,217,+
21,9,6,7,43,+
34,16,72,65,187,+
8,26,66,42,142,+
36,45,98,80,259,+
92,31,58,82,263,+
62,87,48,99,296,+
3,98,91,39,231,+
75,60,76,56,267,+
34,4,96,49,183,+
70,2,65,94,231,+
21,38,99,24,182,+
39,56,71,67,233,+
25,50,8,71,154,+
82,43,3,59,187,+
52,81,4,58,195,+
58,23,43,2,126,+
64,37,96,62,259,+
55,35,26,9,125,+
32,13,87,73,205,+
70,95,13,24,202,+
96,72,18,77,263,+
95,99,97,66,357,+
23,93,67,48,231,+
41,46,46,14,147,+
8,72,33,31,144,+
52,79,8,16,155,+
64,39,92,17,212,+
90,93,44,38,265,+
29,65,31,4,129,+
93,44,56,33,226,+
61,66,66,11,204,+
35,42,28,64,169,+
93,55,44,57,249,+
77,59,93,78,307,+
13,62,31,39,145,+
70,51,69,5,195,+
89,30,40,38,197,+
48,41,89,21,199,+
20,67,50,32,169,+
84,47,1,20,152,+
53,75,78,42,248,+
89,53,0,79,221,+
57,57,50,48,212,+
29,32,31,93,185,+
10,37,60,96,203,+
34,64,61,74,233,+
20,87,77,44,228,+
34,91,40,84,249,+
53,73,10,32,168,+
17,14,66,78,175,+
17,79,62,18,176,+
84,37,16,63,200,+
49,88,2,26,165,+
97,64,32,72,265,+
79,29,4,61,173,+
77,84,57,76,294,+
41,26,92,62,221,+
82,98,63,21,264,+
72,20,75,51,218,+
93,76,2,65,236,+
51,68,79,39,237,+
17,61,44,20,142,+
37,15,19,93,164,+
2,64,70,75,211,+
33,18,48,14,113,+
13,62,90,93,258,+
7,60,11,78,156,+
55,89,39,71,254,+
98,42,95,83,318,+
45,17,56,61,179,+
53,8,81,38,180,+
9,47,82,67,205,+
86,80,83,99,348,+
84,15,20,78,197,+
51,31,25,87,194,+
13,30,29,54,126,+
73,65,23,48,209,+
2,96,97,11,206,+
33,7,79,22,141,+
30,35,58,44,167,+
37,8,81,37,163,+
18,27,88,73,206,+
46,48,82,11,187,+
39,63,51,31,184,+
26,51,52,10,139,+
98,29,28,29,184,+
47,63,48,53,211,+
38,75,17,1,131,+
2,3,56,40,101,+
17,75,81,85,258,+
5,52,85,80,222,+
35,85,61,35,216,+
92,52,94,11,249,+
54,85,76,20,235,+
3,87,24,51,165,+
72,87,76,82,317,+
59,95,7,89,250,+
40,74,14,17,145,+
64,13,62,11,150,+
97,47,29,4,177,+
95,49,62,67,273,+
38,74,7,90,209,+
42,21,51,5,119,+
71,16,58,1,146,+
16,14,93,54,177,+
48,95,77,56,276,+
80,10,71,41,202,+
51,19,73,50,193,+
85,69,70,62,286,+
76,99,17,84,276,+
58,13,16,73,160,+
78,56,63,34,231,+
40,3,96,41,180,+
83,12,87,60,242,+
42,19,30,79,170,+
41,10,22,15,88,+
73,95,99,67,334,+
30,66,84,92,272,+
51,24,23,39,137,+
27,55,54,73,209,+
61,85,17,70,233,+
37,60,41,54,192,+
19,40,65,7,131,+
12,7,31,43,93,+
30,72,48,0,150,+
84,62,24,77,247,+
14,90,62,47,213,+
65,65,50,46,226,+
16,87,95,71,269,+
88,98,63,6,255,+
8,4,53,3,68,+
18,46,39,37,140,+
8,23,94,47,172,+
5,50,81,56,192,+
1,79,7,81,168,+
27,41,75,11,154,+
13,38,65,73,189,+
66,24,17,1,108,+
55,71,42,88,256,+
73,51,67,74,265,+
85,31,58,18,192,+
88,67,4,54,213,+
58,68,88,44,258,+
84,68,12,84,248,+
77,16,25,6,124,+
90,84,55,97,326,+
84,15,49,24,172,+
72,87,95,39,293,+
46,44,10,86,186,+
49,20,50,81,200,+
71,32,4,53,160,+
92,36,2,20,150,+
86,52,81,77,296,+
75,44,65,87,271,+
43,98,45,71,257,+
2,96,96,42,236,+
50,31,41,42,164,+
47,84,64,43,238,+
67,11,7,51,136,+
8,94,9,85,196,+
58,67,60,30,215,+
55,0,32,52,139,+
30,52,70,92,244,+
2,36,55,37,130,+
59,80,49,22,210,+
8,91,88,82,269,+
5,78,29,47,159,+
29,68,47,59,203,+
46,84,52,27,209,+
10,2,31,31,74,+
57,53,61,17,188,+
0,87,47,91,225,+
7,18,43,58,126,+
26,36,23,46,131,+
8,2,76,55,141,+
59,96,78,19,252,+
20,40,31,57,148,+
87,2,31,87,207,+
97,58,72,66,293,+
43,14,5,56,118,+
51,10,50,13,124,+
72,88,14,72,246,+
89,49,21,11,170,+
6,45,47,33,131,+
8,2,52,38,100,+
36,48,2,38,124,+
44,58,58,16,176,+
72,84,61,66,283,+
52,91,37,55,235,+
94,24,18,49,185,+
30,86,96,73,285,+
7,22,58,42,129,+
40,90,10,13,153,+
90,25,22,72,209,+
62,46,96,34,238,+
83,13,56,16,168,+
17,57,28,94,196,+
25,50,23,10,108,+
25,9,15,32,81,+
25,96,77,67,265,+
46,56,18,57,177,+
52,64,57,19,192,+
17,15,47,37,116,+
53,60,27,84,224,+
55,6,53,7,121,+
65,55,15,27,162,+
55,28,37,12,132,+
87,99,41,95,322,+
18,56,28,73,175,+
45,28,41,49,163,+
44,16,24,25,109,+
46,93,92,30,261,+
9,98,25,16,148,+
17,49,47,64,177,+
44,51,95,83,273,+
79,26,17,47,169,+
34,80,79,67,260,+
19,90,71,51,231,+
95,41,65,5,206,+
24,23,22,25,94,+
75,66,2,62,205,+
87,8,52,22,169,+
57,62,97,45,261,+
96,11,50,0,157,+
7,33,10,18,68,+
68,98,90,80,336,+
61,5,2,39,107,+
41,32,96,4,173,+
98,36,71,45,250,+
75,35,11,72,193,+
8,14,11,68,101,+
60,71,45,38,214,+
22,10,55,55,142,+
94,59,95,92,340,+
40,30,12,79,161,+
31,80,97,39,247,+
92,34,73,65,264,+
46,86,11,53,196,+
72,89,66,80,307,+
3,10,48,31,92,+
18,4,31,40,93,+
59,54,74,43,230,+
85,46,76,90,297,+
68,65,97,2,232,+
59,28,80,69,236,+
69,33,41,24,167,+
38,77,43,84,242,+
91,30,6,18,145,+
20,76,41,10,147,+
84,23,43,64,214,+
60,81,71,82,294,+
41,26,0,30,97,+
21,64,65,85,235,+
91,23,43,39,196,+
71,10,33,76,190,+
6,26,29,89,150,+
26,71,82,59,238,+
22,14,35,11,82,+
71,47,94,82,294,+
92,35,35,99,261,+
1,37,62,76,176,+
23,80,7,55,165,+
8,51,61,54,174,+
6,27,52,14,99,+
47,24,88,72,231,+
78,63,45,16,202,+
55,43,98,69,265,+
82,48,95,47,272,+
94,52,79,41,266,+
25,29,55,48,157,+
29,73,53,85,240,+
3,50,94,8,155,+
12,46,85,48,191,+
26,71,30,54,181,+
88,80,76,90,334,+
3,30,96,53,182,+
76,53,90,53,272,+
33,39,7,16,95,+
48,28,79,73,228,+
13,64,71,61,209,+
65,71,44,14,194,+
56,74,90,52,272,+
95,37,76,95,303,+
96,96,93,16,301,+
89,7,61,27,184,+
21,44,85,47,197,+
15,32,59,21,127,+
31,12,3,87,133,+
58,9,78,94,239,+
69,86,31,9,195,+
37,88,32,84,241,+
67,13,15,35,130,+
60,18,54,15,147,+
28,45,99,20,192,+
45,46,62,75,228,+
7,72,56,85,220,+
38,0,58,79,175,+
65,30,17,40,152,+
48,24,68,71,211,+
17,78,55,43,193,+
5,47,74,83,209,+
55,82,84,88,309,+
47,47,16,82,192,+
33,78,98,83,292,+
20,88,51,89,248,+
69,68,98,5,240,+
18,7,25,28,78,+
48,53,91,9,201,+
70,81,35,1,187,+
9,2,65,33,109,+
56,30,68,8,162,+
53,68,89,73,283,+
90,92,24,80,286,+
72,60,73,76,281,+
83,30,31,30,174,+
79,40,22,6,147,+
61,1,20,99,181,+
25,8,83,5,121,+
40,16,31,82,169,+
54,22,77,10,163,+
4,34,59,48,145,+
48,62,48,2,160,+
70,67,60,45,242,+
63,79,62,10,214,+
24,29,99,9,161,+
62,96,34,99,291,+
32,89,58,30,209,+
54,10,91,28,183,+
65,41,78,9,193,+
68,18,59,9,154,+
34,25,63,10,132,+
45,33,62,75,215,+
54,54,93,27,228,+
29,54,51,22,156,+
42,87,11,13,153,+
42,44,11,89,186,+
93,31,63,58,245,+
60,81,79,82,302,+
80,51,57,11,199,+
41,13,87,15,156,+
18,97,71,45,231,+
1,44,37,65,147,+
74,47,76,49,246,+
49,9,88,78,224,+
4,56,62,89,211,+
91,61,80,95,327,+
35,50,47,94,226,+
17,64,83,43,207,+
67,48,19,73,207,+
46,23,5,82,156,+
20,77,93,19,209,+
30,51,4,25,110,+
98,24,95,77,294,+
1,63,68,70,202,+
85,20,71,21,197,+
76,35,36,11,158,+
71,3,39,22,135,+
24,32,15,69,140,+
96,76,84,10,266,+
95,38,74,46,253,+
55,14,30,72,171,+
53,65,36,52,206,+
50,56,67,97,270,+
45,47,86,5,183,+
66,74,52,60,252,+
48,82,38,99,267,+
10,4,79,28,121,+
12,66,84,96,258,+
40,72,82,26,220,+
81,15,7,68,171,+
99,78,6,9,192,+
93,46,92,79,310,+
1,57,26,66,150,+
52,49,85,81,267,+
0,38,84,85,207,+
22,56,98,95,271,+
31,36,2,15,84,+
68,34,35,98,235,+
35,15,18,71,139,+
89,37,78,61,265,+
32,63,23,28,146,+
28,74,66,79,247,+
31,55,92,33,211,+
19,80,62,0,161,+
9,43,88,5,145,+
55,87,53,91,286,+
18,19,43,30,110,+
49,96,87,63,295,+
17,49,61,52,179,+
25,70,79,5,179,+
5,96,98,97,296,+
3,78,36,42,159,+
42,43,2,13,100,+
26,29,59,46,160,+
96,91,94,86,367,+
18,23,30,35,106,+
38,48,2,71,159,+
76,59,74,16,225,+
26,30,43,99,198,+
83,34,9,54,180,+
82,65,64,24,235,+
2,95,23,99,219,+
79,35,54,42,210,+
16,83,81,77,257,+
66,90,61,65,282,+
14,93,36,25,168,+
66,83,89,69,307,+
40,38,0,61,139,+
59,89,80,31,259,+
15,23,87,41,166,+
6,18,76,90,190,+
37,65,51,66,219,+
64,12,42,23,141,+
85,21,95,29,230,+
50,26,63,91,230,+
65,57,45,87,254,+
95,47,85,31,258,+
79,94,79,72,324,+
37,37,38,30,142,+
81,89,29,5,204,+
76,38,62,61,237,+
68,77,94,91,330,+
79,18,72,4,173,+
81,61,49,95,286,+
47,92,48,22,209,+
33,62,91,10,196,+
98,45,14,84,241,+
21,89,8,3,121,+
47,25,10,2,84,+
86,40,59,64,249,+
19,63,1,14,97,+
0,4,80,85,169,+
18,61,7,30,116,+
50,36,78,27,191,+
60,1,60,3,124,+
98,60,35,31,224,+
86,39,84,8,217,+
88,52,55,39,234,+
37,65,46,4,152,+
29,8,53,18,108,+
96,91,35,16,238,+
82,44,87,87,300,+
90,32,75,1,198,+
92,56,47,39,234,+
72,42,88,32,234,+
38,60,21,3,122,+
13,62,78,19,172,+
23,70,21,78,192,+
1,28,42,96,167,+
98,40,76,64,278,+
92,66,1,60,219,+
72,56,27,42,197,+
93,27,62,4,186,+
52,16,93,47,208,+
63,85,46,17,211,+
20,18,30,48,116,+
2,78,20,23,123,+
2,51,19,68,140,+
91,90,31,18,230,+
63,35,23,79,200,+
33,7,2,86,128,+
87,66,67,59,279,+
10,35,61,95,201,+
67,79,92,91,329,+
19,11,7,79,116,+
90,34,69,39,232,+
98,72,89,77,336,+
27,26,79,81,213,+
4,51,22,48,125,+
75,63,59,24,221,+
7,60,63,87,217,+
39,38,4,86,167,+
79,20,93,90,282,+
6,27,5,77,115,+
32,51,77,14,174,+
83,98,21,61,263,+
67,5,8,70,150,+
18,32,50,86,186,+
70,2,23,88,183,+
34,87,0,99,220,+
72,72,38,36,218,+
24,17,19,22,82,+
6,42,64,64,176,+
37,83,70,25,215,+
18,28,88,38,172,+
22,28,45,69,164,+
32,46,27,84,189,+
83,35,28,91,237,+
73,77,2,43,195,+
22,22,28,96,168,+
40,87,46,46,219,+
8,89,92,19,208,+
49,72,77,77,275,+
8,83,49,7,147,+
78,6,49,9,142,+
74,4,20,5,103,+
30,90,68,26,214,+
75,59,29,66,229,+
91,15,4,29,139,+
85,45,82,27,239,+
30,76,9,85,200,+
14,79,27,19,139,+
32,36,42,97,207,+
57,40,84,26,207,+
56,19,82,30,187,+
96,99,52,72,319,+
81,87,36,72,276,+
33,66,70,64,233,+
7,80,52,52,191,+
9,25,44,81,159,+
51,88,40,91,270,+
0,73,41,13,127,+
96,90,31,60,277,+
73,84,19,79,255,+
60,96,18,97,271,+
43,92,46,8,189,+
93,87,45,12,237,+
15,55,3,55,128,+
31,42,95,7,175,+
9,87,5,48,149,+
27,39,98,94,258,+
43,56,26,58,183,+
38,40,74,4,156,+
47,84,25,63,219,+
32,30,13,65,140,+
43,86,71,14,214,+
47,31,37,75,190,+
59,2,14,60,135,+
11,96,14,65,186,+
88,63,74,47,272,+
83,91,4,56,234,+
73,46,51,47,217,+
46,89,65,6,206,+
63,30,77,13,183,+
75,55,96,12,238,+
0,33,27,83,143,+
88,97,78,98,361,+
87,94,71,62,314,+
5,21,8,8,42,+
83,17,91,95,286,+
67,63,69,80,279,+
74,56,54,8,192,+
11,10,79,88,188,+
63,56,17,87,223,+
12,65,33,13,123,+
53,40,72,11,176,+
94,98,19,87,298,+
8,4,74,99,185,+
79,46,43,1,169,+
56,93,72,45,266,+
46,0,80,96,222,+
4,36,55,39,134,+
63,31,92,91,277,+
19,27,4,56,106,+
23,27,55,57,162,+
5,2,20,58,85,+
23,96,16,74,209,+
43,88,70,42,243,+
9,17,17,7,50,+
63,45,89,44,241,+
25,63,83,84,255,+
5,88,36,86,215,+
82,23,20,68,193,+
61,48,65,52,226,+
41,6,26,59,132,+
42,58,91,98,289,+
62,80,69,24,235,+
44,72,41,5,162,+
83,30,64,14,191,+
80,25,98,37,240,+
79,29,40,22,170,+
71,68,25,4,168,+
66,62,43,97,268,+
31,16,71,89,207,+
36,43,82,80,241,+
15,44,22,4,85,+
7,82,68,11,168,+
5,72,43,49,169,+
66,3,25,3,97,+
3,29,6,18,56,+
48,16,23,60,147,+
64,96,99,10,269,+
89,25,42,19,175,+
89,90,53,83,315,+
4,9,97,45,155,+
85,43,57,99,284,+
5,14,9,99,127,+
85,63,33,43,224,+
0,93,7,90,190,+
94,54,58,73,279,+
55,65,97,34,251,+
45,62,51,20,178,+
23,73,96,81,273,+
70,93,96,86,345,+
32,67,42,71,212,+
28,4,7,96,135,+
69,64,38,67,238,+
60,92,56,53,261,+
1,90,5,57,153,+
30,25,77,71,203,+
1,25,24,47,97,+
16,6,64,69,155,+
83,26,69,8,186,+
9,57,90,92,248,+
47,35,52,45,179,+
34,34,12,76,156,+
5,19,79,96,199,+
85,52,77,8,222,+
55,2,97,6,160,+
36,6,57,7,106,+
27,96,52,0,175,+
79,66,42,12,199,+
67,65,25,87,244,+
31,97,94,10,232,+
30,65,26,43,164,+
67,54,70,14,205,+
21,45,3,63,132,+
34,48,41,75,198,+
98,41,59,68,266,+
94,14,25,18,151,+
46,4,22,98,170,+
90,52,54,39,235,+
68,71,85,49,273,+
53,63,90,5,211,+
18,35,63,8,124,+
23,97,20,86,226,+
55,83,98,86,322,+
58,2,47,43,150,+
7,65,60,13,145,+
46,56,23,41,166,+
98,89,64,24,275,+
12,49,97,51,209,+
31,89,36,60,216,+
42,98,12,3,155,+
99,84,87,49,319,+
76,13,74,66,229,+
69,62,1,50,182,+
93,93,66,70,322,+
6,39,50,91,186,+
48,89,54,7,198,+
64,44,55,62,225,+
71,86,16,66,239,+
97,40,10,26,173,+
33,47,11,88,179,+
5,25,14,10,54,+
79,63,15,9,166,+
85,41,76,54,256,+
22,34,92,95,243,+
99,35,61,17,212,+
51,61,31,82,225,+
44,92,63,22,221,+
55,20,93,41,209,+
20,64,49,83,216,+
99,65,48,74,286,+
24,0,52,5,81,+
34,80,27,2,143,+
92,54,83,38,267,+
54,9,68,35,166,+
62,19,40,99,220,+
54,43,54,42,193,+
66,44,65,50,225,+
6,88,44,25,163,+
73,82,44,84,283,+
33,64,34,84,215,+
90,50,4,65,209,+
14,85,57,65,221,+
54,72,89,38,253,+
80,35,95,63,273,+
24,88,36,84,232,+
97,59,37,52,245,+
22,85,46,62,215,+
79,51,51,32,213,+
88,45,34,88,255,+
68,10,29,65,172,+
71,68,4,92,235,+
58,48,87,1,194,+
10,11,65,8,94,+
92,5,14,22,133,+
14,24,67,43,148,+
69,52,94,36,251,+
17,31,60,69,177,+
25,89,42,91,247,+
82,53,70,97,302,+
43,38,10,20,111,+
4,73,58,70,205,+
41,39,24,98,202,+
15,73,21,28,137,+
33,60,89,4,186,+
19,69,20,33,141,+
96,22,10,82,210,+
19,51,37,97,204,+
6,73,63,37,179,+
76,51,41,54,222,+
19,23,44,48,134,+
19,38,9,22,88,+
13,70,21,73,177,+
52,12,47,8,119,+
75,92,92,33,292,+
90,76,37,73,276,+
44,37,81,17,179,+
17,18,54,95,184,+
4,53,3,47,107,+
97,13,86,15,211,+
13,40,13,40,106,+
43,45,6,76,170,+
25,44,5,24,98,+
2,11,11,86,110,+
31,70,41,76,218,+
95,36,72,71,274,+
23,62,8,70,163,+
42,86,74,98,300,+
21,19,91,64,195,+
13,23,16,70,122,+
23,75,22,79,199,+
51,99,28,37,215,+
97,9,73,42,221,+
32,68,89,88,277,+
27,20,66,10,123,+
88,22,38,82,230,+
55,96,76,45,272,+
23,73,74,88,258,+
35,88,56,58,237,+
80,16,4,83,183,+
1,9,53,23,86,+
53,28,94,27,202,+
81,69,32,67,249,+
93,87,49,35,264,+
72,33,66,14,185,+
31,94,4,11,140,+
45,21,93,51,210,+
98,23,30,44,195,+
13,62,93,2,170,+
17,65,8,34,124,+
57,55,14,17,143,+
68,37,34,12,151,+
92,34,73,7,206,+
99,81,83,41,304,+
43,53,36,44,176,+
75,7,42,82,206,+
56,79,32,52,219,+
57,77,30,11,175,+
23,54,87,77,241,+
43,62,2,21,128,+
8,77,85,44,214,+
99,56,42,10,207,+
55,33,42,49,179,+
83,82,4,40,209,+
28,32,69,6,135,+
6,52,42,95,195,+
86,63,75,2,226,+
53,53,66,94,266,+
5,97,57,90,249,+
47,67,2,64,180,+
28,53,73,79,233,+
77,68,76,32,253,+
34,82,99,66,281,+
52,95,62,12,221,+
9,43,5,27,84,+
86,51,41,6,184,+
49,10,80,61,200,+
67,23,68,81,239,+
14,53,85,49,201,+
91,75,66,76,308,+
39,58,8,67,172,+
19,29,44,49,141,+
10,83,11,49,153,+
59,86,8,78,231,+
7,52,16,30,105,+
34,25,41,58,158,+
69,76,0,98,243,+
27,39,62,49,177,+
79,23,17,34,153,+
3,16,38,52,109,+
55,66,15,92,228,+
20,36,64,25,145,+
8,8,38,3,57,+
2,12,85,5,104,+
52,49,11,62,174,+
91,95,23,10,219,+
21,40,22,86,169,+
7,9,83,83,182,+
60,13,47,76,196,+
52,22,57,35,166,+
3,41,63,44,151,+
70,24,64,7,165,+
80,51,4,82,217,+
59,48,87,92,286,+
9,8,23,37,77,+
82,32,72,33,219,+
58,93,55,65,271,+
66,7,69,17,159,+
50,99,86,59,294,+
16,9,26,46,97,+
54,54,24,65,197,+
91,44,93,32,260,+
9,67,44,80,200,+
55,80,30,18,183,+
12,77,59,71,219,+
17,41,92,48,198,+
87,96,16,26,225,+
50,66,27,10,153,+
33,77,62,86,258,+
0,65,38,78,181,+
1,87,39,77,204,+
68,45,43,64,220,+
64,94,6,18,182,+
65,59,85,49,258,+
58,88,5,73,224,+
36,99,48,23,206,+
52,82,8,51,193,+
35,28,72,92,227,+
35,33,36,60,164,+
61,54,18,47,180,+
80,95,84,48,307,+
11,45,64,76,196,+
2,56,65,50,173,+
64,82,20,70,236,+
67,38,35,22,162,+
9,82,13,68,172,+
57,23,66,16,162,+
40,62,98,82,282,+
70,82,7,76,235,+
51,45,99,44,239,+
43,0,71,83,197,+
99,34,52,25,210,+
83,67,31,51,232,+
33,92,9,19,153,+
81,98,56,1,236,+
7,69,36,19,131,+
78,69,37,74,258,+
32,40,71,19,162,+
96,98,64,34,292,+
17,88,91,67,263,+
32,14,86,8,140,+
0,19,8,39,66,+
53,54,24,8,139,+
35,85,86,55,261,+
64,45,19,43,171,+
37,50,24,54,165,+
94,33,75,29,231,+
39,17,35,74,165,+
71,24,52,96,243,+
86,3,39,2,130,+
83,50,40,79,252,+
83,12,35,96,226,+
96,41,40,0,177,+
27,23,3,16,69,+
87,89,59,25,260,+
61,25,47,12,145,+
6,67,53,12,138,+
73,45,34,64,216,+
46,69,4,57,176,+
15,60,37,15,127,+
17,33,15,55,120,+
77,45,35,66,223,+
44,19,29,54,146,+
26,57,11,0,94,+
0,63,83,4,150,+
0,81,8,99,188,+
84,11,11,9,115,+
63,65,37,78,243,+
91,23,76,97,287,+
79,36,56,98,269,+
82,58,31,1,172,+
15,53,74,8,150,+
36,85,45,83,249,+
75,52,44,19,190,+
5,50,1,75,131,+
1,99,63,2,165,+
5,92,5,90,192,+
76,44,47,55,222,+
56,12,52,95,215,+
36,97,89,24,246,+
88,68,59,99,314,+
79,23,54,13,169,+
25,19,47,15,106,+
19,39,54,28,140,+
79,23,58,64,224,+
68,60,19,47,194,+
53,37,29,41,160,+
91,38,4,17,150,+
55,98,26,46,225,+
29,59,80,62,230,+
53,12,66,48,179,+
63,41,84,36,224,+
49,25,13,30,117,+
92,19,83,88,282,+
1,16,53,69,139,+
62,31,73,46,212,+
18,54,24,55,151,+
37,89,40,16,182,+
98,53,7,95,253,+
63,66,66,75,270,+
23,16,50,45,134,+
66,26,65,14,171,+
76,78,96,23,273,+
84,54,68,77,283,+
11,70,91,11,183,+
84,8,11,58,161,+
76,25,7,63,171,+
18,29,96,66,209,+
77,62,89,69,297,+
96,90,48,91,325,+
40,31,50,96,217,+
25,40,1,47,113,+
91,26,49,53,219,+
21,30,38,27,116,+
90,79,49,70,288,+
90,99,12,23,224,+
75,47,59,70,251,+
68,60,11,8,147,+
46,15,17,70,148,+
70,51,41,11,173,+
8,12,90,35,145,+
27,16,47,88,178,+
13,35,95,36,179,+
42,35,61,65,203,+
19,94,11,40,164,+
49,88,71,24,232,+
30,49,0,58,137,+
79,4,43,64,190,+
19,8,89,6,122,+
13,18,82,63,176,+
95,97,90,33,315,+
92,96,97,47,332,+
9,23,27,89,148,+
67,9,31,94,201,+
45,41,53,88,227,+
84,65,75,18,242,+
67,69,37,19,192,+
16,46,23,52,137,+
49,89,99,57,294,+
63,78,25,22,188,+
3,71,80,10,164,+
71,66,5,77,219,+
48,51,83,18,200,+
5,57,37,11,110,+
60,9,95,68,232,+
48,0,95,30,173,+
1,64,32,81,178,+
96,69,89,20,274,+
27,78,12,83,200,+
38,41,64,31,174,+
24,94,37,37,192,+
16,53,35,82,186,+
90,84,11,3,188,+
68,55,98,69,290,+
2,99,39,5,145,+
6,99,6,25,136,+
22,76,36,82,216,+
10,53,12,22,97,+
45,31,89,31,196,+
83,52,36,66,237,+
5,10,95,93,203,+
52,96,67,60,275,+
81,1,95,39,216,+
18,33,93,68,212,+
29,75,46,46,196,+
62,73,92,68,295,+
64,11,54,83,212,+
30,94,22,89,235,+
68,11,89,34,202,+
27,62,0,97,186,+
16,36,14,27,93,+
91,49,42,28,210,+
72,45,17,71,205,+
60,70,28,10,168,+
29,77,45,60,211,+
2,48,24,71,145,+
5,94,45,37,181,+
0,17,75,39,131,+
98,51,76,12,237,+
55,65,12,54,186,+
26,70,85,33,214,+
49,78,20,58,205,+
82,54,17,86,239,+
89,20,25,91,225,+
33,23,30,29,115,+
91,34,84,91,300,+
83,95,30,39,247,+
68,70,73,3,214,+
39,92,94,68,293,+
10,85,87,14,196,+
86,60,90,9,245,+
9,1,33,3,46,+
63,97,42,20,222,+
88,89,59,27,263,+
37,40,44,64,185,+
7,49,65,77,198,+
86,20,94,40,240,+
52,82,4,46,184,+
63,27,35,5,130,+
69,75,10,31,185,+
9,17,39,39,104,+
53,62,20,46,181,+
51,53,87,98,289,+
10,80,34,78,202,+
32,29,94,13,168,+
43,89,9,35,176,+
35,43,61,62,201,+
82,86,10,0,178,+
78,32,47,16,173,+
20,22,19,12,73,+
52,37,27,69,185,+
39,38,88,30,195,+
0,67,10,75,152,+
21,53,95,41,210,+
30,97,42,44,213,+
38,32,22,72,164,+
17,80,54,61,212,+
4,57,50,44,155,+
0,66,53,58,177,+
51,37,14,99,201,+
75,18,49,8,150,+
12,10,12,9,43,+
21,37,72,57,187,+
37,52,75,16,180,+
70,88,29,21,208,+
48,10,65,39,162,+
45,52,31,71,199,+
72,1,58,92,223,+
86,90,44,10,230,+
58,61,76,53,248,+
99,41,99,47,286,+
78,39,10,29,156,+
72,58,96,43,269,+
85,91,9,66,251,+
14,88,85,99,286,+
90,89,98,64,341,+
22,15,80,96,213,+
95,24,32,29,180,+
85,66,82,21,254,+
58,80,30,19,187,+
8,39,55,72,174,+
42,33,23,2,100,+
30,13,35,49,127,+
37,41,76,59,213,+
63,38,89,74,264,+
2,52,87,39,180,+
27,64,19,25,135,+
28,64,80,66,238,+
20,15,78,36,149,+
1,69,93,29,192,+
15,1,91,78,185,+
53,97,16,9,175,+
70,77,4,3,154,+
79,56,81,55,271,+
1,10,73,38,122,+
77,99,50,36,262,+
80,88,19,52,239,+
88,60,67,23,238,+
16,75,93,54,238,+
72,96,28,15,211,+
32,54,67,76,229,+
24,31,17,7,79,+
63,39,63,70,235,+
94,51,28,3,176,+
32,35,41,50,158,+
17,23,67,27,134,+
26,4,33,71,134,+
40,83,12,63,198,+
98,66,59,15,238,+
37,19,74,9,139,+
99,5,63,23,190,+
15,14,96,99,224,+
56,69,63,90,278,+
34,70,56,2,162,+
47,10,41,8,106,+
78,13,20,53,164,+
12,57,83,31,183,+
80,88,52,15,235,+
57,84,36,45,222,+
63,42,69,30,204,+
72,65,58,72,267,+
51,95,53,19,218,+
20,89,59,42,210,+
62,40,42,47,191,+
25,90,89,4,208,+
7,58,18,46,129,+
54,83,93,17,247,+
77,45,97,48,267,+
41,67,21,61,190,+
72,20,12,77,181,+
42,17,41,52,152,+
84,10,32,57,183,+
16,94,72,86,268,+
96,0,56,0,152,+
60,64,17,35,176,+
47,28,28,23,126,+
57,36,88,96,277,+
30,63,4,77,174,+
97,83,45,58,283,+
93,12,56,93,254,+
45,99,59,10,213,+
94,72,75,35,276,+
19,11,85,91,206,+
89,59,94,74,316,+
4,41,99,32,176,+
1,41,91,27,160,+
84,33,21,15,153,+
92,99,19,96,306,+
2,91,38,26,157,+
16,53,34,43,146,+
92,94,85,7,278,+
31,96,51,22,200,+
5,16,74,7,102,+
61,89,9,68,227,+
51,49,12,39,151,+
87,0,77,74,238,+
81,22,36,20,159,+
24,22,27,93,166,+
13,98,99,61,271,+
65,97,73,81,316,+
22,14,22,68,126,+
20,69,38,41,168,+
97,51,25,35,208,+
1,91,11,11,114,+
66,59,68,35,228,+
25,19,74,88,206,+
79,77,14,99,269,+
54,82,86,93,315,+
82,84,66,30,262,+
77,72,16,94,259,+
47,65,45,82,239,+
1,10,42,97,150,+
14,56,4,73,147,+
46,83,26,47,202,+
3,18,11,53,85,+
73,57,46,65,241,+
31,88,33,98,250,+
86,33,83,42,244,+
4,59,90,19,172,+
54,13,43,2,112,+
5,8,66,14,93,+
13,24,76,98,211,+
67,10,89,57,223,+
5,71,49,13,138,+
48,27,30,90,195,+
70,2,13,3,88,+
71,20,61,32,184,+
49,44,28,47,168,+
93,41,63,48,245,+
60,10,13,93,176,+
75,42,71,0,188,+
70,63,13,46,192,+
61,4,84,97,246,+
19,83,28,36,166,+
37,72,10,85,204,+
60,73,88,9,230,+
54,2,98,59,213,+
28,2,77,11,118,+
17,15,37,60,129,+
58,62,6,21,147,+
78,50,42,65,235,+
37,67,95,1,200,+
6,20,55,20,101,+
91,93,89,67,340,+
34,90,84,20,228,+
34,5,97,47,183,+
87,71,67,76,301,+
91,77,75,16,259,+
94,53,8,43,198,+
33,10,93,65,201,+
48,11,27,85,171,+
46,26,53,51,176,+
67,78,0,50,195,+
63,98,28,56,245,+
13,76,27,24,140,+
42,81,6,72,201,+
90,96,75,94,355,+
28,41,16,76,161,+
57,8,21,55,141,+
57,64,73,42,236,+
8,57,39,66,170,+
75,74,99,22,270,+
30,28,81,93,232,+
38,19,15,97,169,+
82,59,74,63,278,+
25,27,77,98,227,+
1,46,96,83,226,+
14,37,72,1,124,+
82,86,7,0,175,+
84,92,53,24,253,+
78,22,19,16,135,+
96,4,34,13,147,+
59,64,54,87,264,+
25,61,34,6,126,+
35,59,94,67,255,+
79,11,47,37,174,+
69,82,88,78,317,+
12,74,77,82,245,+
35,20,96,63,214,+
72,37,89,65,263,+
32,58,91,57,238,+
40,29,57,24,150,+
67,85,1,80,233,+
39,63,48,45,195,+
26,34,33,19,112,+
27,99,97,45,268,+
80,93,71,94,338,+
47,50,47,53,197,+
8,97,47,80,232,+
46,38,50,92,226,+
52,68,67,10,197,+
75,21,46,88,230,+
66,10,35,6,117,+
64,39,71,83,257,+
79,52,1,59,191,+
2,94,51,65,212,+
7,24,77,66,174,+
39,71,35,10,155,+
76,41,6,65,188,+
29,67,49,96,241,+
99,34,2,97,232,+
25,74,0,4,103,+
14,96,96,1,207,+
53,33,60,79,225,+
2,6,5,44,57,+
63,99,72,95,329,+
72,89,6,48,215,+
37,63,49,88,237,+
1,38,6,59,104,+
31,40,61,84,216,+
31,68,73,54,226,+
48,47,51,31,177,+
67,53,71,93,284,+
5,24,8,51,88,+
28,6,84,7,125,+
69,85,99,34,287,+
83,54,94,21,252,+
53,87,83,42,265,+
80,93,48,96,317,+
64,58,36,72,230,+
80,28,60,30,198,+
97,29,2,34,162,+
89,24,15,73,201,+
50,61,69,4,184,+
95,42,41,52,230,+
94,53,64,58,269,+
23,52,43,36,154,+
5,11,13,77,106,+
56,2,71,13,142,+
81,32,50,59,222,+
78,50,75,69,272,+
60,91,34,82,267,+
63,33,48,99,243,+
61,43,26,67,197,+
29,37,25,34,125,+
4,13,68,10,95,+
0,98,12,4,114,+
11,88,51,21,171,+
1,24,6,9,40,+
70,36,53,98,257,+
81,6,50,90,227,+
86,87,17,74,264,+
57,52,52,68,229,+
78,3,0,28,109,+
9,77,1,5,92,+
93,41,0,23,157,+
99,95,74,8,276,+
66,82,91,15,254,+
18,24,67,84,193,+
14,38,96,73,221,+
88,21,96,4,209,+
95,81,32,83,291,+
20,14,36,76,146,+
26,32,90,20,168,+
11,86,53,47,197,+
67,12,76,97,252,+
30,38,40,87,195,+
75,74,41,67,257,+
5,28,64,83,180,+
94,46,89,16,245,+
72,95,90,19,276,+
16,11,51,72,150,+
2,5,30,71,108,+
83,29,49,94,255,+
60,89,36,13,198,+
35,98,10,80,223,+
72,90,54,35,251,+
97,73,69,63,302,+
67,62,89,29,247,+
85,50,44,69,248,+
36,79,53,79,247,+
91,33,97,48,269,+
83,53,69,31,236,+
4,66,7,42,119,+
77,10,15,78,180,+
36,34,25,96,191,+
87,15,47,74,223,+
6,2,75,27,110,+
40,76,28,62,206,+
33,29,41,18,121,+
60,3,25,36,124,+
61,97,95,80,333,+
20,42,85,42,189,+
42,32,83,35,192,+
86,39,41,48,214,+
7,17,51,95,170,+
96,5,45,23,169,+
31,13,63,15,122,+
37,90,88,5,220,+
15,89,93,70,267,+
48,91,20,29,188,+
14,39,29,2,84,+
3,52,38,23,116,+
27,86,47,62,222,+
8,92,7,18,125,+
80,76,59,42,257,+
85,71,92,15,263,+
20,66,50,8,144,+
2,52,44,44,142,+
94,34,81,79,288,+
96,60,21,40,217,+
59,30,9,7,105,+
89,92,51,46,278,+
49,55,61,81,246,+
20,89,94,53,256,+
42,68,8,49,167,+
5,24,8,31,68,+
96,4,1,85,186,+
40,6,65,97,208,+
54,56,38,7,155,+
96,86,45,83,310,+
48,40,18,10,116,+
8,43,80,60,191,+
38,6,21,64,129,+
7,76,43,51,177,+
40,16,20,42,118,+
23,79,13,53,168,+
36,8,66,10,120,+
1,88,32,95,216,+
74,68,81,19,242,+
39,21,57,14,131,+
50,98,47,84,279,+
6,73,1,74,154,+
50,87,2,48,187,+
44,60,64,28,196,+
60,96,63,71,290,+
48,43,46,32,169,+
21,97,10,82,210,+
55,89,84,37,265,+
69,93,42,6,210,+
29,31,83,48,191,+
18,51,17,83,169,+
50,84,53,56,243,+
41,95,85,30,251,+
36,41,22,38,137,+
2,10,11,10,33,+
75,8,71,90,244,+
38,11,92,21,162,+
91,4,68,54,217,+
22,88,94,16,220,+
97,40,22,3,162,+
5,80,25,47,157,+
37,53,98,76,264,+
44,75,51,60,230,+
97,38,5,69,209,+
29,38,85,80,232,+
9,55,80,71,215,+
63,71,2,61,197,+
19,95,79,39,232,+
92,65,80,70,307,+
71,0,5,13,89,+
37,97,70,29,233,+
68,27,91,54,240,+
92,33,43,59,227,+
19,82,95,22,218,+
21,23,29,90,163,+
17,71,50,43,181,+
62,59,59,31,211,+
78,29,23,83,213,+
53,39,68,23,183,+
23,50,79,29,181,+
7,15,14,25,61,+
93,90,53,89,325,+
70,46,40,64,220,+
43,59,61,39,202,+
37,30,3,46,116,+
0,10,97,48,155,+
64,46,6,96,212,+
94,35,2,50,181,+
21,52,66,67,206,+
8,53,0,58,119,+
76,9,43,48,176,+
72,83,68,63,286,+
9,50,20,0,79,+
89,87,36,68,280,+
65,40,67,93,265,+
79,37,41,58,215,+
25,49,0,68,142,+
74,56,66,60,256,+
81,35,5,14,135,+
63,33,14,7,117,+
15,40,28,91,174,+
5,41,38,35,119,+
24,6,60,44,134,+
66,36,34,53,189,+
72,42,18,39,171,+
22,37,93,28,180,+
30,67,11,84,192,+
89,43,44,39,215,+
65,0,89,52,206,+
71,89,99,76,335,+
67,15,77,74,233,+
15,79,57,12,163,+
76,10,26,72,184,+
37,37,46,86,206,+
91,55,97,48,291,+
97,22,26,62,207,+
59,71,69,0,199,+
26,10,16,84,136,+
49,59,33,38,179,+
33,43,35,57,168,+
23,11,32,77,143,+
12,87,92,13,204,+
3,42,7,25,77,+
33,85,69,94,281,+
25,81,42,87,235,+
32,97,17,75,221,+
12,22,62,60,156,+
15,55,80,85,235,+
10,12,50,5,77,+
35,29,22,30,116,+
58,45,31,70,204,+
40,52,12,24,128,+
6,50,39,72,167,+
44,62,40,79,225,+
72,19,24,62,177,+
77,27,16,27,147,+
81,47,85,59,272,+
23,4,77,82,186,+
33,28,6,90,157,+
52,12,31,10,105,+
19,81,46,44,190,+
32,99,31,31,193,+
18,71,17,4,110,+
58,17,44,53,172,+
30,35,51,3,119,+
80,40,2,7,129,+
55,62,89,94,300,+
37,13,15,43,108,+
28,51,95,46,220,+
88,71,98,72,329,+
12,19,41,55,127,+
51,99,65,34,249,+
5,13,58,5,81,+
70,33,42,6,151,+
11,89,43,93,236,+
15,21,52,8,96,+
34,92,16,62,204,+
43,70,36,11,160,+
50,28,1,4,83,+
10,72,84,66,232,+
85,54,31,94,264,+
67,17,37,4,125,+
79,4,20,0,103,+
72,65,0,80,217,+
32,81,98,23,234,+
28,24,56,76,184,+
39,48,34,12,133,+
37,84,52,88,261,+
2,40,0,8,50,+
36,6,21,8,71,+
99,21,92,87,299,+
54,36,57,94,241,+
2,98,55,78,233,+
36,91,42,15,184,+
75,29,46,98,248,+
78,95,32,67,272,+
87,85,58,21,251,+
74,88,77,22,261,+
70,27,1,13,111,+
16,75,82,70,243,+
30,8,24,30,92,+
66,36,72,33,207,+
73,18,69,69,229,+
35,31,94,81,241,+
88,13,17,97,215,+
44,55,26,0,125,+
82,80,92,91,345,+
24,62,56,26,168,+
41,67,7,72,187,+
81,78,50,72,281,+
70,49,7,60,186,+
9,14,63,58,144,+
98,58,33,24,213,+
90,98,11,44,243,+
20,78,24,53,175,+
17,86,84,33,220,+
55,17,42,40,154,+
59,26,38,83,206,+
45,13,28,80,166,+
3,3,69,34,109,+
6,7,89,65,167,+
49,4,12,86,151,+
54,59,61,39,213,+
39,91,52,51,233,+
47,53,50,64,214,+
24,63,10,13,110,+
82,55,9,83,229,+
38,43,12,18,111,+
57,85,8,7,157,+
97,56,2,92,247,+
3,84,60,24,171,+
78,21,6,55,160,+
30,92,39,42,203,+
9,25,40,61,135,+
75,73,56,16,220,+
74,1,70,95,240,+
87,27,23,18,155,+
41,54,31,34,160,+
62,12,81,67,222,+
13,9,20,99,141,+
7,91,54,96,248,+
18,3,48,43,112,+
52,30,96,34,212,+
85,59,77,33,254,+
85,14,18,33,150,+
79,21,69,22,191,+
13,58,23,76,170,+
11,14,75,99,199,+
46,28,85,50,209,+
94,41,24,78,237,+
2,12,30,64,108,+
14,27,74,2,117,+
52,26,29,60,167,+
46,2,40,99,187,+
5,72,78,80,235,+
96,17,27,30,170,+
36,26,99,2,163,+
63,79,21,18,181,+
18,38,58,77,191,+
82,75,25,93,275,+
59,80,76,96,311,+
94,47,29,81,251,+
37,38,59,4,138,+
67,63,90,25,245,+
96,98,18,74,286,+
3,54,38,8,103,+
94,27,41,57,219,+
42,67,62,70,241,+
84,48,54,9,195,+
12,94,97,39,242,+
85,8,4,9,106,+
17,56,83,35,191,+
30,15,0,18,63,+
94,5,56,35,190,+
4,89,66,61,220,+
89,41,35,23,188,+
16,37,7,71,131,+
77,27,38,95,237,+
48,81,77,8,214,+
57,91,10,6,164,+
98,29,64,88,279,+
29,70,59,12,170,+
30,8,43,92,173,+
30,1,28,76,135,+
46,61,16,20,143,+
59,72,13,30,174,+
19,71,30,74,194,+
6,75,45,69,195,+
9,32,3,53,97,+
62,55,70,24,211,+
59,53,33,38,183,+
74,48,51,38,211,+
91,74,19,0,184,+
15,31,23,65,134,+
48,30,4,19,101,+
42,16,58,47,163,+
12,8,91,71,182,+
86,26,2,18,132,+
82,74,11,33,200,+
16,40,26,43,125,+
49,12,51,94,206,+
82,27,91,47,247,+
18,97,51,44,210,+
53,98,11,57,219,+
85,72,65,30,252,+
49,41,95,52,237,+
2,27,12,14,55,+
46,98,92,51,287,+
51,82,46,34,213,+
99,55,31,21,206,+
48,81,50,29,208,+
23,8,43,31,105,+
88,42,11,41,182,+
81,28,27,19,155,+
38,1,87,28,154,+
24,16,71,60,171,+
61,3,6,81,151,+
13,64,59,59,195,+
61,43,67,84,255,+
89,91,13,97,290,+
32,98,67,40,237,+
92,52,51,8,203,+
24,53,94,77,248,+
92,18,12,49,171,+
71,90,88,19,268,+
58,47,89,48,242,+
95,43,0,20,158,+
65,96,77,11,249,+
53,23,31,64,171,+
19,29,11,52,111,+
15,42,51,27,135,+
43,18,75,9,145,+
47,65,55,5,172,+
77,20,50,8,155,+
11,17,84,52,164,+
30,15,83,26,154,+
5,97,46,77,225,+
3,8,3,43,57,+
98,95,55,48,296,+
11,44,81,3,139,+
27,48,88,12,175,+
66,75,57,56,254,+
62,85,28,0,175,+
76,32,32,40,180,+
61,64,31,0,156,+
12,56,88,50,206,+
26,13,82,20,141,+
78,94,51,62,285,+
80,6,58,27,171,+
74,51,61,94,280,+
57,81,49,8,195,+
3,80,12,89,184,+
69,78,67,94,308,+
87,19,49,34,189,+
98,96,49,3,246,+
47,85,28,32,192,+
25,39,39,13,116,+
39,70,99,59,267,+
62,75,15,38,190,+
17,84,33,87,221,+
64,18,73,25,180,+
7,30,60,62,159,+
28,8,77,48,161,+
39,12,49,77,177,+
10,25,96,74,205,+
24,13,36,55,128,+
61,88,80,28,257,+
18,54,69,97,238,+
8,26,96,15,145,+
45,62,87,90,284,+
32,53,59,7,151,+
97,59,10,4,170,+
29,49,17,0,95,+
29,97,75,23,224,+
57,16,53,12,138,+
97,5,15,24,141,+
29,66,85,31,211,+
4,56,63,10,133,+
81,4,21,64,170,+
90,10,56,50,206,+
43,25,33,24,125,+
95,56,15,46,212,+
99,65,43,87,294,+
44,33,21,81,179,+
98,41,53,94,286,+
88,19,73,14,194,+
40,40,22,46,148,+
52,67,58,38,215,+
85,83,88,9,265,+
39,39,56,35,169,+
67,95,50,74,286,+
14,34,4,22,74,+
10,53,42,51,156,+
17,37,13,20,87,+
89,5,93,74,261,+
66,43,20,37,166,+
10,43,10,88,151,+
93,29,58,44,224,+
97,10,21,14,142,+
56,99,75,43,273,+
44,69,28,72,213,+
61,9,61,97,228,+
2,46,89,75,212,+
98,93,37,51,279,+
43,18,4,7,72,+
39,42,86,81,248,+
30,86,41,91,248,+
27,7,99,60,193,+
74,61,69,88,292,+
26,30,57,95,208,+
61,99,69,73,302,+
21,94,12,35,162,+
94,29,24,43,190,+
17,89,98,96,300,+
16,57,99,83,255,+
87,66,72,35,260,+
2,75,12,54,143,+
75,46,60,73,254,+
11,91,87,26,215,+
2,21,76,70,169,+
93,61,14,91,259,+
21,69,81,13,184,+
5,66,6,13,90,+
12,63,69,22,166,+
93,93,93,96,375,+
46,24,38,89,197,+
28,8,48,10,94,+
20,17,40,31,108,+
78,88,15,83,264,+
30,78,13,60,181,+
25,45,97,97,264,+
90,73,36,14,213,+
50,6,57,42,155,+
77,63,73,67,280,+
26,79,21,0,126,+
67,52,41,99,259,+
58,30,35,38,161,+
54,93,68,81,296,+
53,55,83,95,286,+
37,24,67,26,154,+
89,70,89,84,332,+
67,52,15,0,134,+
62,66,90,79,297,+
32,42,11,69,154,+
84,76,44,9,213,+
50,69,20,97,236,+
2,93,76,68,239,+
53,23,90,95,261,+
25,82,70,63,240,+
77,45,59,16,197,+
83,32,50,41,206,+
89,7,24,47,167,+
40,64,95,10,209,+
98,33,50,62,243,+
89,63,65,46,263,+
4,48,71,77,200,+
58,1,3,70,132,+
69,55,42,59,225,+
99,36,61,61,257,+
5,99,72,69,245,+
4,12,50,85,151,+
51,57,94,10,212,+
11,81,33,87,212,+
38,44,55,43,180,+
41,1,10,53,105,+
3,87,11,27,128,+
96,80,33,13,222,+
32,36,99,31,198,+
12,7,96,91,206,+
44,57,9,49,159,+
76,2,30,14,122,+
74,58,55,48,235,+
44,93,50,39,226,+
74,55,92,61,282,+
88,49,95,79,311,+
77,79,13,30,199,+
10,30,73,32,145,+
42,29,25,73,169,+
22,91,14,43,170,+
8,99,6,11,124,+
40,99,92,85,316,+
23,23,94,89,229,+
57,72,27,25,181,+
57,92,97,19,265,+
83,24,60,46,213,+
33,44,66,16,159,+
77,24,94,96,291,+
51,18,48,80,197,+
4,40,13,67,124,+
70,12,81,50,213,+
77,51,80,58,266,+
31,99,1,19,150,+
41,37,67,53,198,+
70,74,48,72,264,+
97,6,68,40,211,+
78,43,83,90,294,+
33,14,8,25,80,+
8,93,65,21,187,+
57,77,76,54,264,+
58,45,75,28,206,+
44,21,79,41,185,+
23,15,25,52,115,+
10,50,35,4,99,+
56,12,88,25,181,+
39,46,93,60,238,+
62,71,82,15,230,+
66,79,3,10,158,+
96,48,89,32,265,+
25,35,31,42,133,+
12,87,19,19,137,+
53,20,95,48,216,+
75,80,73,10,238,+
25,16,94,86,221,+
70,6,51,66,193,+
11,60,39,54,164,+
57,81,22,83,243,+
39,6,63,80,188,+
48,73,86,42,249,+
42,94,72,23,231,+
19,31,12,83,145,+
34,15,81,25,155,+
21,49,87,44,201,+
3,63,92,57,215,+
76,62,70,19,227,+
89,6,62,71,228,+
22,11,62,65,160,+
85,10,4,19,118,+
85,22,57,90,254,+
59,51,53,73,236,+
90,99,87,91,367,+
85,8,94,79,266,+
82,37,2,61,182,+
91,45,38,1,175,+
94,77,57,45,273,+
35,58,45,10,148,+
57,8,71,47,183,+
96,25,82,69,272,+
84,44,49,35,212,+
54,19,3,56,132,+
8,95,17,69,189,+
49,29,69,28,175,+
44,32,30,98,204,+
62,78,74,59,273,+
22,12,68,50,152,+
57,84,48,87,276,+
53,22,78,68,221,+
13,84,77,42,216,+
60,57,22,77,216,+
22,48,79,36,185,+
24,40,1,57,122,+
83,55,61,4,203,+
19,75,84,89,267,+
69,47,10,36,162,+
27,62,56,77,222,+
35,21,88,30,174,+
47,15,58,63,183,+
12,39,23,68,142,+
19,14,69,17,119,+
57,62,47,96,262,+
44,50,51,26,171,+
21,77,14,27,139,+
93,18,16,53,180,+
70,49,28,14,161,+
78,19,21,52,170,+
40,8,70,34,152,+
56,40,57,79,232,+
76,32,72,55,235,+
48,72,30,28,178,+
47,47,95,65,254,+
72,89,50,45,256,+
3,41,16,55,115,+
0,7,19,92,118,+
61,7,55,22,145,+
60,48,96,75,279,+
8,2,11,61,82,+
46,25,17,65,153,+
28,71,29,68,196,+
84,60,92,0,236,+
79,48,85,41,253,+
51,54,31,16,152,+
78,19,7,49,153,+
43,91,99,88,321,+
77,39,52,20,188,+
7,31,49,41,128,+
29,75,34,14,152,+
64,16,88,57,225,+
90,32,53,6,181,+
33,55,23,96,207,+
95,38,38,72,243,+
46,80,29,42,197,+
61,42,31,49,183,+
68,20,93,52,233,+
23,10,60,90,183,+
41,52,82,91,266,+
44,28,57,69,198,+
25,12,5,57,99,+
13,24,36,21,94,+
0,51,18,31,100,+
78,84,33,63,258,+
65,81,87,40,273,+
71,69,35,51,226,+
5,86,84,57,232,+
4,18,81,0,103,+
70,38,74,63,245,+
10,55,32,48,145,+
57,91,49,86,283,+
61,61,9,63,194,+
65,33,83,82,263,+
71,98,63,85,317,+
4,80,42,0,126,+
44,5,51,34,134,+
80,4,40,45,169,+
36,12,98,67,213,+
35,34,55,69,193,+
90,56,27,95,268,+
27,11,64,92,194,+
33,98,77,34,242,+
3,78,8,22,111,+
22,82,35,70,209,+
41,14,72,20,147,+
86,80,59,21,246,+
77,60,87,64,288,+
32,34,41,60,167,+
64,47,91,36,238,+
96,92,15,48,251,+
28,0,76,64,168,+
37,71,58,17,183,+
89,51,12,72,224,+
57,44,88,88,277,+
79,93,26,72,270,+
9,81,44,42,176,+
47,29,40,9,125,+
2,88,89,97,276,+
96,52,59,5,212,+
56,60,63,55,234,+
41,67,91,84,283,+
15,98,26,85,224,+
97,8,45,61,211,+
99,67,79,30,275,+
33,56,20,69,178,+
23,7,87,50,167,+
16,74,5,80,175,+
90,83,10,4,187,+
90,87,38,5,220,+
81,44,15,54,194,+
77,57,3,27,164,+
80,59,76,44,259,+
2,91,32,86,211,+
45,8,63,53,169,+
41,96,72,97,306,+
50,73,69,67,259,+
49,41,33,45,168,+
35,20,33,22,110,+
78,87,83,74,322,+
64,37,93,47,241,+
22,43,33,57,155,+
85,30,26,43,184,+
30,36,39,94,199,+
62,20,7,3,92,+
21,1,58,3,83,+
93,20,98,39,250,+
76,55,7,62,200,+
29,59,71,82,241,+
87,93,38,32,250,+
18,25,0,83,126,+
38,26,28,78,170,+
16,50,68,88,222,+
45,22,44,68,179,+
86,3,63,47,199,+
92,50,98,53,293,+
46,41,99,7,193,+
92,65,84,41,282,+
95,70,66,55,286,+
3,4,49,28,84,+
2,52,62,83,199,+
41,92,37,68,238,+
34,66,82,45,227,+
13,13,29,10,65,+
75,44,50,10,179,+
47,84,12,16,159,+
49,56,24,59,188,+
71,36,52,13,172,+
93,91,30,57,271,+
48,57,18,47,170,+
80,9,90,36,215,+
4,98,55,82,239,+
56,55,85,6,202,+
13,47,38,34,132,+
13,90,25,94,222,+
50,76,97,72,295,+
46,66,96,68,276,+
42,41,79,8,170,+
3,72,9,32,116,+
56,68,13,93,230,+
98,36,74,51,259,+
89,15,60,22,186,+
76,21,88,43,228,+
69,1,21,68,159,+
71,28,57,12,168,+
71,15,46,19,151,+
58,33,83,82,256,+
88,26,29,67,210,+
27,82,2,96,207,+
67,58,62,60,247,+
39,20,68,65,192,+
5,91,35,27,158,+
89,21,4,68,182,+
70,13,87,20,190,+
95,29,26,55,205,+
43,5,97,72,217,+
90,8,94,6,198,+
87,11,6,58,162,+
47,28,59,99,233,+
14,56,99,85,254,+
8,18,23,78,127,+
14,77,59,63,213,+
35,81,59,71,246,+
12,91,32,36,171,+
51,50,39,40,180,+
9,83,21,25,138,+
2,21,48,20,91,+
44,75,5,14,138,+
10,36,25,88,159,+
0,22,33,49,104,+
40,64,52,83,239,+
95,7,56,18,176,+
79,54,27,34,194,+
54,51,68,45,218,+
60,41,61,29,191,+
15,4,85,92,196,+
60,93,1,89,243,+
19,14,92,90,215,+
12,92,34,69,207,+
4,8,7,35,54,+
73,33,95,17,218,+
76,8,90,5,179,+
47,89,43,60,239,+
46,47,90,73,256,+
47,60,34,1,142,+
79,16,82,90,267,+
81,15,64,16,176,+
66,46,95,84,291,+
25,20,29,23,97,+
52,0,16,71,139,+
27,76,5,28,136,+
0,73,51,41,165,+
36,82,48,45,211,+
41,4,1,90,136,+
73,38,83,76,270,+
42,49,45,0,136,+
1,68,98,10,177,+
91,28,15,43,177,+
22,51,31,79,183,+
29,79,29,9,146,+
56,78,1,90,225,+
93,2,14,57,166,+
81,3,98,89,271,+
30,31,62,92,215,+
76,7,71,54,208,+
0,51,6,14,71,+
67,22,24,68,181,+
85,46,21,51,203,+
21,55,72,62,210,+
77,8,69,24,178,+
7,38,26,85,156,+
27,75,10,5,117,+
35,82,56,26,199,+
44,75,82,96,297,+
71,81,5,16,173,+
81,81,32,89,283,+
96,14,88,57,255,+
62,58,80,27,227,+
64,43,99,67,273,+
53,43,10,75,181,+
16,19,60,12,107,+
12,56,74,83,225,+
96,7,52,15,170,+
37,93,48,83,261,+
96,75,2,33,206,+
48,22,37,78,185,+
1,49,39,5,94,+
22,19,58,5,104,+
55,16,92,51,214,+
25,82,60,72,239,+
30,15,33,55,133,+
57,87,79,42,265,+
77,48,96,9,230,+
62,52,7,92,213,+
37,78,55,76,246,+
62,4,42,35,143,+
11,39,19,13,82,+
23,38,96,62,219,+
15,12,39,54,120,+
14,76,97,50,237,+
28,2,97,75,202,+
69,15,56,52,192,+
45,58,66,27,196,+
5,47,0,80,132,+
61,90,21,2,174,+
11,58,3,14,86,+
30,86,90,77,283,+
91,21,15,92,219,+
71,51,90,70,282,+
23,42,3,39,107,+
65,45,2,70,182,+
7,54,36,35,132,+
97,88,38,13,236,+
38,3,65,51,157,+
41,72,82,22,217,+
14,78,48,59,199,+
34,11,94,29,168,+
17,81,53,21,172,+
89,18,24,37,168,+
29,69,23,77,198,+
63,64,85,63,275,+
94,51,23,35,203,+
53,6,71,52,182,+
30,95,42,14,181,+
71,3,96,78,248,+
71,89,0,57,217,+
44,61,85,96,286,+
90,28,8,31,157,+
28,94,98,47,267,+
27,41,34,74,176,+
60,3,50,58,171,+
71,92,74,80,317,+
78,51,74,53,256,+
80,6,43,43,172,+
14,21,17,50,102,+
74,95,57,1,227,+
91,82,36,17,226,+
19,55,3,4,81,+
29,41,29,36,135,+
49,26,40,65,180,+
45,19,72,7,143,+
34,78,73,53,238,+
81,85,62,83,311,+
79,62,72,77,290,+
90,77,97,11,275,+
17,19,74,88,198,+
46,18,90,36,190,+
28,12,53,44,137,+
33,69,49,96,247,+
83,51,96,11,241,+
51,82,97,15,245,+
39,33,55,26,153,+
25,61,22,36,144,+
92,15,76,16,199,+
83,86,91,40,300,+
84,3,54,29,170,+
73,76,41,97,287,+
99,65,65,28,257,+
14,18,12,92,136,+
45,35,83,82,245,+
59,56,73,73,261,+
46,1,21,90,158,+
14,12,59,92,177,+
67,75,79,23,244,+
8,56,39,71,174,+
61,6,27,16,110,+
49,33,69,56,207,+
55,58,74,56,243,+
76,81,18,95,270,+
9,37,1,97,144,+
26,89,37,67,219,+
3,20,42,52,117,+
18,57,58,83,216,+
25,22,28,18,93,+
69,6,14,43,132,+
24,59,17,36,136,+
52,89,50,65,256,+
14,70,36,25,145,+
87,55,56,53,251,+
3,3,99,38,143,+
71,76,31,8,186,+
74,63,85,34,256,+
11,33,10,47,101,+
2,67,60,59,188,+
5,75,75,22,177,+
63,0,16,86,165,+
0,52,21,46,119,+
73,17,42,86,218,+
1,62,16,93,172,+
98,66,38,57,259,+
54,72,81,17,224,+
55,87,47,15,204,+
14,91,32,74,211,+
65,43,3,99,210,+
75,18,30,99,222,+
81,78,46,50,255,+
36,26,6,57,125,+
40,0,64,92,196,+
69,57,61,74,261,+
21,75,84,44,224,+
93,99,43,11,246,+
94,26,36,37,193,+
39,31,10,7,87,+
19,36,62,81,198,+
28,96,70,47,241,+
90,25,34,56,205,+
77,92,33,5,207,+
62,78,29,90,259,+
8,60,46,12,126,+
3,61,75,23,162,+
87,53,76,12,228,+
14,96,33,56,199,+
7,5,69,65,146,+
43,44,22,7,116,+
22,80,62,61,225,+
53,32,66,59,210,+
88,22,70,0,180,+
99,41,99,50,289,+
90,30,41,5,166,+
48,96,80,69,293,+
39,96,88,61,284,+
72,47,41,59,219,+
26,55,29,78,188,+
28,47,75,68,218,+
19,13,42,37,111,+
8,74,2,8,92,+
26,9,89,45,169,+
75,82,24,63,244,+
42,38,78,44,202,+
66,68,49,9,192,+
69,98,33,38,238,+
23,1,2,71,97,+
65,95,58,8,226,+
7,65,22,71,165,+
22,67,88,68,245,+
46,74,35,91,246,+
65,75,45,23,208,+
53,54,28,24,159,+
98,23,50,26,197,+
87,80,54,49,270,+
19,11,44,23,97,+
63,27,46,68,204,+
32,14,58,17,121,+
61,2,57,87,207,+
52,90,34,34,210,+
57,47,26,29,159,+
53,74,16,62,205,+
72,0,36,72,180,+
50,55,57,30,192,+
91,46,85,56,278,+
60,66,80,48,254,+
25,1,33,67,126,+
20,43,81,12,156,+
39,17,80,48,184,+
33,4,32,23,92,+
43,62,59,33,197,+
79,80,74,5,238,+
82,61,41,25,209,+
3,79,53,8,143,+
3,51,96,52,202,+
64,15,57,76,212,+
71,53,34,50,208,+
23,45,26,90,184,+
14,66,87,8,175,+
24,4,3,9,40,+
43,5,47,33,128,+
40,83,76,20,219,+
49,36,15,75,175,+
29,25,58,13,125,+
35,75,87,23,220,+
10,20,80,13,123,+
88,86,24,80,278,+
7,81,58,64,210,+
69,84,73,48,274,+
42,0,62,23,127,+
52,40,45,53,190,+
77,18,45,42,182,+
69,46,37,45,197,+
47,15,15,60,137,+
28,77,67,30,202,+
40,35,32,94,201,+
44,94,39,76,253,+
29,58,61,8,156,+
24,54,14,16,108,+
0,18,52,24,94,+
94,92,90,39,315,+
36,78,49,57,220,+
84,48,97,86,315,+
24,67,21,84,196,+
27,70,75,75,247,+
0,97,37,38,172,+
72,33,62,56,223,+
80,61,98,50,289,+
6,30,52,1,89,+
28,8,87,40,163,+
50,30,24,72,176,+
23,10,6,31,70,+
4,94,28,68,194,+
97,51,11,70,229,+
35,33,93,27,188,+
24,68,22,67,181,+
32,76,31,27,166,+
2,0,15,75,92,+
17,33,99,81,230,+
40,63,11,87,201,+
17,93,31,96,237,+
79,37,59,28,203,+
34,19,44,82,179,+
98,89,72,35,294,+
26,70,98,25,219,+
27,85,69,90,271,+
14,23,74,48,159,+
4,30,58,79,171,+
41,35,73,81,230,+
28,77,71,60,236,+
43,48,12,3,106,+
9,68,57,56,190,+
50,15,70,0,135,+
64,52,61,80,257,+
39,29,45,61,174,+
9,18,34,16,77,+
21,81,72,10,184,+
7,64,82,84,237,+
4,86,27,5,122,+
96,81,10,47,234,+
80,17,41,52,190,+
55,20,85,29,189,+
70,85,3,60,218,+
88,6,94,29,217,+
0,75,31,63,169,+
79,40,96,5,220,+
38,16,97,76,227,+
8,6,16,49,79,+
71,94,7,14,186,+
43,83,31,18,175,+
22,1,33,12,68,+
98,16,36,10,160,+
0,33,35,59,127,+
45,14,1,75,135,+
20,61,44,96,221,+
37,94,36,82,249,+
28,98,73,4,203,+
18,5,78,68,169,+
84,11,72,22,189,+
79,69,60,87,295,+
90,33,14,33,170,+
94,20,3,22,139,+
39,17,11,22,89,+
31,83,44,17,175,+
51,41,62,81,235,+
88,44,99,41,272,+
44,81,80,95,300,+
78,36,83,80,277,+
29,2,17,36,84,+
74,76,28,45,223,+
44,96,33,49,222,+
44,52,68,48,212,+
10,14,38,38,100,+
37,28,12,65,142,+
6,52,70,33,161,+
77,55,61,11,204,+
93,24,90,57,264,+
11,89,13,43,156,+
97,47,27,18,189,+
54,22,86,76,238,+
43,47,17,80,187,+
74,47,38,96,255,+
96,48,44,74,262,+
18,21,10,72,121,+
58,92,65,58,273,+
86,16,26,34,162,+
30,0,59,26,115,+
28,73,81,20,202,+
92,67,72,15,246,+
0,8,18,34,60,+
16,77,54,94,241,+
85,85,84,64,318,+
57,39,93,47,236,+
3,85,74,48,210,+
16,55,61,11,143,+
87,35,98,96,316,+
46,69,25,27,167,+
29,35,40,21,125,+
27,99,76,55,257,+
58,32,39,64,193,+
22,42,56,81,201,+
76,3,13,0,92,+
20,75,9,54,158,+
81,22,90,71,264,+
30,96,95,50,271,+
15,57,10,55,137,+
84,40,97,44,265,+
87,94,65,99,345,+
29,60,6,52,147,+
68,78,17,21,184,+
63,97,64,14,238,+
30,2,63,31,126,+
54,68,85,11,218,+
10,77,53,85,225,+
59,66,10,34,169,+
62,37,1,26,126,+
9,11,7,89,116,+
5,1,57,8,71,+
51,12,6,47,116,+
1,63,97,65,226,+
57,27,93,67,244,+
77,83,6,0,166,+
51,93,98,92,334,+
13,9,90,31,143,+
74,43,41,63,221,+
0,99,77,79,255,+
22,97,11,45,175,+
68,91,52,65,276,+
49,49,7,49,154,+
6,18,35,81,140,+
34,18,53,13,118,+
11,98,41,17,167,+
12,91,74,48,225,+
16,83,27,44,170,+
43,90,70,44,247,+
24,84,93,9,210,+
60,16,45,84,205,+
64,4,57,75,200,+
89,12,44,54,199,+
67,67,15,51,200,+
53,9,92,81,235,+
98,84,87,97,366,+
44,16,16,47,123,+
55,13,34,10,112,+
84,22,70,26,202,+
71,30,80,27,208,+
15,3,27,93,138,+
64,11,57,37,169,+
30,52,13,6,101,+
44,61,88,53,246,+
57,31,84,52,224,+
29,77,61,16,183,+
14,23,60,2,99,+
86,70,31,55,242,+
85,40,37,91,253,+
2,12,26,78,118,+
93,19,23,3,138,+
31,23,36,5,95,+
6,13,6,26,51,+
70,54,22,79,225,+
8,51,67,47,173,+
21,84,3,81,189,+
76,88,9,38,211,+
74,84,7,96,261,+
34,51,5,52,142,+
99,9,53,39,200,+
93,55,73,32,253,+
11,82,39,10,142,+
45,18,14,60,137,+
83,9,92,8,192,+
7,89,88,18,202,+
56,33,50,24,163,+
4,74,89,57,224,+
47,95,51,32,225,+
25,41,26,36,128,+
1,98,39,29,167,+
49,29,69,54,201,+
81,4,54,67,206,+
2,68,35,91,196,+
34,20,97,15,166,+
77,45,78,91,291,+
19,77,16,97,209,+
71,42,89,26,228,+
58,98,27,23,206,+
20,28,11,35,94,+
86,26,77,49,238,+
50,62,20,98,230,+
24,79,96,57,256,+
28,48,37,95,208,+
98,76,40,31,245,+
38,98,8,58,202,+
55,29,5,64,153,+
91,35,67,2,195,+
78,47,54,18,197,+
66,54,53,52,225,+
43,50,44,97,234,+
41,74,84,14,213,+
36,35,20,61,152,+
33,8,84,81,206,+
63,28,26,4,121,+
63,70,46,46,225,+
61,19,64,84,228,+
37,86,92,73,288,+
80,91,71,36,278,+
70,57,83,60,270,+
54,63,19,94,230,+
99,1,37,37,174,+
8,97,86,12,203,+
20,72,80,24,196,+
54,45,82,53,234,+
9,50,64,66,189,+
19,12,16,61,108,+
64,65,35,17,181,+
92,79,10,68,249,+
54,33,29,56,172,+
33,77,53,77,240,+
16,18,41,17,92,+
4,30,52,82,168,+
83,71,33,86,273,+
38,58,88,54,238,+
55,81,86,40,262,+
79,51,70,68,268,+
12,17,1,97,127,+
33,61,22,21,137,+
98,21,97,46,262,+
4,55,30,71,160,+
2,52,69,58,181,+
28,24,53,35,140,+
56,46,10,70,182,+
64,97,84,77,322,+
42,13,10,61,126,+
12,77,12,3,104,+
38,23,27,6,94,+
34,96,23,67,220,+
91,34,49,22,196,+
50,57,95,55,257,+
3,45,10,87,145,+
72,69,26,25,192,+
72,0,54,24,150,+
13,0,64,39,116,+
76,36,82,9,203,+
16,62,79,98,255,+
57,86,54,17,214,+
44,16,40,21,121,+
28,22,23,98,171,+
18,95,9,39,161,+
29,62,32,21,144,+
72,70,62,61,265,+
8,91,11,78,188,+
96,25,42,5,168,+
97,16,53,7,173,+
90,3,33,94,220,+
5,9,10,19,43,+
6,63,91,47,207,+
96,93,70,80,339,+
16,47,84,41,188,+
60,24,92,99,275,+
36,18,50,84,188,+
64,72,62,8,206,+
72,3,20,60,155,+
37,42,13,24,116,+
53,70,29,53,205,+
88,1,62,21,172,+
47,49,36,91,223,+
5,92,12,66,175,+
81,97,33,14,225,+
3,46,71,89,209,+
31,53,91,13,188,+
86,40,40,84,250,+
62,82,41,87,272,+
23,29,0,50,102,+
74,17,54,22,167,+
66,88,13,74,241,+
7,94,38,46,185,+
60,43,7,46,156,+
19,35,28,3,85,+
87,35,66,22,210,+
44,24,39,14,121,+
78,13,27,28,146,+
42,68,51,66,227,+
8,11,5,33,57,+
33,66,3,17,119,+
23,3,90,22,138,+
73,6,39,99,217,+
22,70,15,64,171,+
7,34,85,34,160,+
25,53,22,20,120,+
14,4,64,92,174,+
95,32,14,1,142,+
26,6,20,67,119,+
37,28,5,8,78,+
73,52,97,1,223,+
32,99,16,98,245,+
2,62,40,21,125,+
7,18,69,23,117,+
64,30,98,88,280,+
23,70,37,2,132,+
55,35,30,30,150,+
64,99,43,11,217,+
6,91,60,16,173,+
6,31,26,86,149,+
99,71,87,96,353,+
10,0,83,18,111,+
79,58,47,89,273,+
97,80,33,23,233,+
50,30,69,15,164,+
65,46,25,44,180,+
23,35,28,94,180,+
7,36,94,13,150,+
5,42,85,98,230,+
63,41,83,82,269,+
86,90,14,91,281,+
60,31,20,56,167,+
1,39,28,65,133,+
98,60,42,57,257,+
86,42,75,96,299,+
45,65,0,84,194,+
91,32,34,46,203,+
59,49,71,33,212,+
34,75,91,29,229,+
5,17,20,66,108,+
74,70,91,34,269,+
25,88,69,91,273,+
36,30,43,6,115,+
42,54,12,23,131,+
73,40,37,59,209,+
9,20,18,87,134,+
65,47,15,2,129,+
89,35,96,36,256,+
92,12,67,86,257,+
28,39,59,42,168,+
87,4,71,10,172,+
84,55,81,20,240,+
60,53,47,35,195,+
93,21,63,89,266,+
70,12,13,18,113,+
34,93,38,92,257,+
70,2,53,32,157,+
12,35,8,1,56,+
55,33,47,3,138,+
39,74,22,49,184,+
54,94,71,26,245,+
42,24,92,12,170,+
64,61,15,18,158,+
89,59,90,78,316,+
47,0,32,25,104,+
62,3,77,98,240,+
59,10,18,89,176,+
20,24,99,91,234,+
80,63,12,64,219,+
90,97,46,38,271,+
28,94,50,11,183,+
80,33,80,12,205,+
75,41,41,12,169,+
76,78,38,43,235,+
21,48,25,93,187,+
3,12,55,11,81,+
2,88,47,9,146,+
5,64,26,1,96,+
51,72,51,66,240,+
46,1,99,92,238,+
41,16,28,28,113,+
9,44,72,37,162,+
27,72,64,49,212,+
36,43,88,73,240,+
63,80,78,44,265,+
34,31,25,24,114,+
86,81,87,11,265,+
37,66,24,15,142,+
40,86,48,43,217,+
46,60,11,49,166,+
26,75,46,67,214,+
15,1,46,68,130,+
61,11,29,98,199,+
81,50,10,35,176,+
59,68,11,60,198,+
83,68,60,60,271,+
31,49,62,60,202,+
1,74,10,93,178,+
1,94,53,16,164,+
37,9,83,31,160,+
48,94,99,62,303,+
91,79,91,61,322,+
92,18,61,69,240,+
54,56,30,58,198,+
27,45,16,62,150,+
33,13,45,32,123,+
85,73,77,17,252,+
11,19,30,16,76,+
69,53,25,87,234,+
32,93,72,39,236,+
53,97,29,10,189,+
8,35,4,19,66,+
46,76,49,22,193,+
14,0,59,39,112,+
91,41,4,85,221,+
49,44,63,74,230,+
46,46,56,63,211,+
17,91,49,79,236,+
15,87,66,58,226,+
42,91,23,93,249,+
54,43,16,87,200,+
39,71,41,75,226,+
52,25,54,41,172,+
84,76,49,8,217,+
66,73,37,96,272,+
19,45,8,87,159,+
31,66,67,96,260,+
16,75,30,93,214,+
41,86,73,0,200,+
18,59,45,16,138,+
31,44,23,49,147,+
11,88,99,58,256,+
52,46,87,56,241,+
7,67,21,29,124,+
26,63,1,42,132,+
70,19,44,71,204,+
99,87,1,62,249,+
71,55,25,99,250,+
16,58,21,8,103,+
94,74,16,54,238,+
36,15,27,24,102,+
30,99,81,23,233,+
48,84,70,81,283,+
57,55,12,38,162,+
96,93,16,12,217,+
74,80,30,18,202,+
43,26,59,85,213,+
26,88,81,78,273,+
65,97,90,44,296,+
24,82,29,71,206,+
22,88,76,35,221,+
82,4,51,99,236,+
1,81,42,99,223,+
85,23,86,32,226,+
31,80,19,77,207,+
18,11,80,0,109,+
71,99,83,22,275,+
14,68,27,78,187,+
29,70,23,4,126,+
69,48,8,13,138,+
20,36,1,2,59,+
19,74,59,35,187,+
59,80,42,33,214,+
58,43,11,35,147,+
23,93,75,33,224,+
55,24,42,1,122,+
35,97,95,47,274,+
18,26,85,29,158,+
85,33,7,76,201,+
42,98,20,97,257,+
45,17,58,11,131,+
74,48,83,50,255,+
70,75,17,93,255,+
38,51,25,52,166,+
18,38,58,26,140,+
9,39,21,64,133,+
24,86,94,22,226,+
96,84,67,9,256,+
51,24,48,5,128,+
54,49,27,43,173,+
51,30,11,34,126,+
58,17,67,5,147,+
49,19,53,31,152,+
75,60,39,62,236,+
55,93,11,83,242,+
93,23,72,55,243,+
8,75,98,35,216,+
23,79,75,94,271,+
59,48,90,86,283,+
87,2,5,83,177,+
52,6,61,35,154,+
14,97,96,40,247,+
50,44,44,74,212,+
74,46,38,60,218,+
93,81,8,61,243,+
39,95,46,63,243,+
60,77,25,25,187,+
91,49,77,72,289,+
77,84,12,88,261,+
50,68,70,44,232,+
12,62,49,35,158,+
8,64,47,1,120,+
48,44,14,94,200,+
27,90,2,54,173,+
24,92,60,28,204,+
88,8,17,78,191,+
99,65,52,64,280,+
53,24,79,38,194,+
40,59,39,40,178,+
62,60,76,98,296,+
19,36,71,49,175,+
6,64,6,78,154,+
48,79,63,2,192,+
12,72,40,95,219,+
25,24,74,3,126,+
16,24,66,59,165,+
76,15,19,98,208,+
92,29,63,79,263,+
34,77,15,82,208,+
28,30,19,15,92,+
61,75,11,83,230,+
77,8,36,69,190,+
57,14,75,26,172,+
28,17,10,29,84,+
90,10,55,98,253,+
55,57,96,91,299,+
88,71,84,1,244,+
32,65,49,67,213,+
1,4,56,71,132,+
75,74,97,86,332,+
83,47,94,18,242,+
79,48,99,24,250,+
55,49,36,40,180,+
4,46,80,28,158,+
84,90,47,92,313,+
70,35,70,30,205,+
91,67,74,69,301,+
13,99,50,83,245,+
94,45,81,11,231,+
11,94,93,90,288,+
18,49,30,93,190,+
93,92,62,71,318,+
29,12,67,44,152,+
75,93,27,86,281,+
52,83,97,23,255,+
41,9,23,78,151,+
2,42,49,19,112,+
7,90,28,25,150,+
70,64,6,8,148,+
61,0,64,66,191,+
18,8,59,25,110,+
92,20,2,48,162,+
66,90,24,34,214,+
97,93,84,90,364,+
7,33,54,54,148,+
87,99,13,24,223,+
75,3,66,3,147,+
31,31,30,96,188,+
68,6,1,44,119,+
34,81,68,99,282,+
15,82,56,3,156,+
26,40,24,24,114,+
94,93,89,31,307,+
72,48,86,48,254,+
65,16,51,83,215,+
18,49,16,70,153,+
76,44,19,42,181,+
82,80,87,30,279,+
23,37,86,11,157,+
2,85,73,86,246,+
97,46,50,35,228,+
26,69,57,11,163,+
40,59,83,12,194,+
38,53,47,63,201,+
39,23,22,87,171,+
90,83,65,52,290,+
45,93,81,50,269,+
93,26,89,77,285,+
1,51,94,17,163,+
95,49,51,64,259,+
3,18,51,60,132,+
55,79,73,99,306,+
72,74,37,41,224,+
59,63,85,43,250,+
20,63,52,78,213,+
16,57,54,89,216,+
24,66,58,12,160,+
10,95,41,92,238,+
87,19,97,42,245,+
1,75,13,16,105,+
90,37,64,62,253,+
96,85,48,65,294,+
69,80,13,19,181,+
81,87,62,86,316,+
43,98,38,43,222,+
14,64,65,3,146,+
30,48,20,7,105,+
78,17,45,2,142,+
83,43,35,73,234,+
59,42,32,68,201,+
45,20,63,22,150,+
73,85,59,23,240,+
34,45,97,91,267,+
3,87,53,90,233,+
26,99,41,39,205,+
32,80,96,82,290,+
32,41,33,16,122,+
49,8,8,35,100,+
93,31,3,81,208,+
43,81,64,43,231,+
91,67,10,56,224,+
31,75,12,71,189,+
81,84,87,23,275,+
4,60,65,69,198,+
30,74,6,69,179,+
24,33,62,82,201,+
54,35,37,37,163,+
9,59,54,90,212,+
88,30,12,31,161,+
88,28,17,2,135,+
8,67,97,74,246,+
93,62,65,16,236,+
81,80,80,59,300,+
1,44,3,36,84,+
47,37,79,51,214,+
83,5,87,52,227,+
90,63,9,30,192,+
86,0,34,55,175,+
73,19,24,72,188,+
79,28,84,0,191,+
27,96,75,66,264,+
99,1,70,71,241,+
90,56,87,84,317,+
67,15,74,2,158,+
38,44,34,17,133,+
43,27,27,89,186,+
27,0,82,37,146,+
92,44,73,36,245,+
22,7,76,60,165,+
41,91,78,16,226,+
38,23,94,38,193,+
87,42,68,92,289,+
71,55,59,14,199,+
68,30,56,59,213,+
99,17,35,87,238,+
34,34,2,37,107,+
94,64,35,5,198,+
60,87,15,32,194,+
94,62,96,0,252,+
30,4,47,66,147,+
23,20,73,1,117,+
39,53,71,99,262,+
6,36,42,76,160,+
72,84,23,65,244,+
74,70,24,12,180,+
26,15,32,59,132,+
92,25,72,48,237,+
97,67,14,42,220,+
78,46,17,10,151,+
31,66,40,86,223,+
82,25,92,59,258,+
7,68,78,46,199,+
2,86,46,45,179,+
1,63,47,80,191,+
20,30,14,86,150,+
75,19,75,10,179,+
80,17,67,61,225,+
18,61,33,28,140,+
79,67,10,34,190,+
73,10,49,74,206,+
10,97,80,99,286,+
53,54,11,26,144,+
28,80,77,52,237,+
93,63,80,8,244,+
51,5,74,51,181,+
84,35,21,80,220,+
63,81,77,49,270,+
23,69,62,1,155,+
61,29,63,82,235,+
97,54,82,43,276,+
71,54,84,7,216,+
20,0,77,35,132,+
19,73,74,65,231,+
54,51,59,75,239,+
61,68,27,16,172,+
64,1,79,85,229,+
89,18,96,56,259,+
29,60,47,91,227,+
32,81,41,52,206,+
88,23,80,38,229,+
65,27,99,45,236,+
46,58,60,23,187,+
34,71,79,44,228,+
80,11,89,67,247,+
99,2,42,42,185,+
34,56,21,37,148,+
47,19,56,23,145,+
96,94,8,23,221,+
67,81,82,3,233,+
65,76,80,12,233,+
35,98,73,31,237,+
7,23,67,35,132,+
38,11,5,89,143,+
33,71,20,44,168,+
16,59,14,24,113,+
98,27,93,28,246,+
66,68,8,83,225,+
35,7,72,23,137,+
74,40,29,22,165,+
46,52,45,43,186,+
75,90,26,39,230,+
59,60,79,71,269,+
77,95,57,70,299,+
60,89,3,67,219,+
31,30,53,32,146,+
59,88,96,48,291,+
55,16,64,93,228,+
83,87,19,45,234,+
47,0,32,34,113,+
9,7,40,70,126,+
79,45,0,20,144,+
38,17,95,97,247,+
84,27,8,38,157,+
71,12,10,44,137,+
48,10,73,97,228,+
96,54,44,89,283,+
84,71,8,42,205,+
29,28,15,13,85,+
75,96,20,37,228,+
61,92,63,85,301,+
27,25,9,69,130,+
61,87,49,83,280,+
70,84,68,73,295,+
52,89,82,62,285,+
91,58,13,63,225,+
31,56,20,53,160,+
93,60,68,97,318,+
9,57,31,24,121,+
42,71,97,17,227,+
38,22,55,95,210,+
58,3,31,87,179,+
24,17,3,92,136,+
96,47,27,13,183,+
15,3,83,74,175,+
75,3,50,26,154,+
79,52,97,15,243,+
62,26,95,3,186,+
96,1,93,11,201,+
83,23,39,21,166,+
61,9,33,80,183,+
76,15,42,31,164,+
85,63,18,34,200,+
83,48,36,36,203,+
20,12,82,62,176,+
29,36,53,14,132,+
45,14,92,16,167,+
15,98,47,60,220,+
14,0,90,58,162,+
22,12,67,31,132,+
37,93,29,67,226,+
6,90,13,54,163,+
1,94,79,73,247,+
48,17,10,92,167,+
20,76,8,50,154,+
64,57,12,62,195,+
22,84,96,39,241,+
45,41,94,96,276,+
4,65,97,87,253,+
66,89,97,52,304,+
52,96,81,97,326,+
49,67,6,22,144,+
72,90,49,66,277,+
31,54,76,57,218,+
59,34,99,66,258,+
30,87,91,28,236,+
87,52,2,38,179,+
95,2,74,70,241,+
34,57,70,38,199,+
61,88,52,5,206,+
61,30,10,72,173,+
6,23,28,26,83,+
42,28,68,52,190,+
16,21,12,20,69,+
77,39,69,40,225,+
10,92,17,93,212,+
15,7,35,73,130,+
72,38,45,8,163,+
72,59,81,99,311,+
13,1,18,74,106,+
26,88,76,29,219,+
74,37,18,25,154,+
52,37,19,78,186,+
58,52,5,4,119,+
7,48,0,5,60,+
57,5,13,42,117,+
85,74,50,39,248,+
66,28,66,45,205,+
62,48,11,11,132,+
18,31,92,16,157,+
87,56,96,42,281,+
13,93,99,92,297,+
70,84,24,81,259,+
26,82,60,31,199,+
0,32,6,81,119,+
52,43,71,6,172,+
48,12,88,8,156,+
63,50,64,71,248,+
86,58,93,23,260,+
95,18,63,16,192,+
92,49,19,35,195,+
57,25,28,40,150,+
36,33,3,43,115,+
81,96,76,29,282,+
3,35,72,41,151,+
79,53,5,81,218,+
14,33,98,89,234,+
13,50,95,84,242,+
72,27,14,92,205,+
11,81,90,84,266,+
52,3,59,44,158,+
26,36,44,45,151,+
79,44,57,86,266,+
9,46,60,14,129,+
99,88,94,79,360,+
87,59,30,12,188,+
47,54,16,66,183,+
69,58,34,81,242,+
56,91,68,79,294,+
69,93,14,9,185,+
39,58,82,67,246,+
54,88,39,60,241,+
43,2,32,87,164,+
36,1,94,6,137,+
89,89,39,55,272,+
85,64,82,22,253,+
69,40,29,17,155,+
97,90,80,17,284,+
74,0,54,48,176,+
35,27,23,27,112,+
60,39,4,15,118,+
68,67,85,61,281,+
94,90,33,83,300,+
2,59,28,62,151,+
88,70,13,82,253,+
72,15,90,83,260,+
76,11,24,75,186,+
15,72,32,33,152,+
75,15,35,54,179,+
76,4,36,15,131,+
68,50,74,89,281,+
89,70,21,53,233,+
79,21,19,4,123,+
7,56,37,46,146,+
7,81,22,78,188,+
44,41,65,68,218,+
87,59,45,13,204,+
77,11,29,3,120,+
93,56,31,81,261,+
99,12,88,11,210,+
28,9,66,10,113,+
53,10,5,40,108,+
29,40,39,26,134,+
65,92,22,10,189,+
95,49,61,4,209,+
85,43,33,71,232,+
46,89,70,27,232,+
10,88,55,56,209,+
99,85,31,91,306,+
79,80,3,36,198,+
98,71,32,2,203,+
87,92,25,62,266,+
57,51,94,83,285,+
24,17,27,44,112,+
70,56,9,3,138,+
48,36,56,17,157,+
35,27,26,45,133,+
91,33,96,41,261,+
8,76,81,22,187,+
18,77,87,11,193,+
58,73,31,96,258,+
22,97,43,24,186,+
16,19,39,47,121,+
56,67,77,97,297,+
74,18,21,22,135,+
46,69,70,31,216,+
84,29,37,58,208,+
61,77,34,40,212,+
55,8,22,82,167,+
39,64,18,17,138,+
84,87,38,71,280,+
74,84,28,25,211,+
53,24,16,38,131,+
19,49,6,41,115,+
39,44,39,4,126,+
95,23,59,17,194,+
46,29,12,24,111,+
79,91,28,91,289,+
97,34,33,74,238,+
59,77,91,43,270,+
55,97,32,61,245,+
86,97,92,38,313,+
93,25,4,80,202,+
12,92,93,39,236,+
82,32,91,64,269,+
69,79,89,7,244,+
95,30,83,97,305,+
78,73,29,51,231,+
21,87,33,37,178,+
50,78,1,12,141,+
45,86,94,27,252,+
95,96,99,15,305,+
46,14,14,8,82,+
90,71,16,8,185,+
34,53,67,84,238,+
70,63,55,58,246,+
23,89,84,30,226,+
54,14,73,0,141,+
77,86,26,72,261,+
61,11,96,47,215,+
80,23,48,65,216,+
70,19,60,32,181,+
75,69,31,89,264,+
88,95,75,87,345,+
39,94,71,42,246,+
9,28,1,13,51,+
72,14,7,40,133,+
51,32,30,22,135,+
20,91,40,36,187,+
64,20,26,87,197,+
62,80,12,86,240,+
43,10,42,2,97,+
80,43,71,11,205,+
90,4,51,90,235,+
47,24,32,23,126,+
65,38,35,30,168,+
60,36,64,29,189,+
79,63,24,36,202,+
36,51,46,5,138,+
83,39,38,93,253,+
26,43,31,79,179,+
53,17,77,90,237,+
95,65,91,27,278,+
46,92,83,99,320,+
33,20,65,46,164,+
25,5,18,50,98,+
11,19,69,0,99,+
48,90,40,37,215,+
46,37,85,7,175,+
11,36,48,91,186,+
60,16,34,49,159,+
67,83,1,76,227,+
77,84,96,31,288,+
95,70,35,67,267,+
59,54,77,42,232,+
92,67,50,62,271,+
9,15,86,47,157,+
65,39,85,59,248,+
14,88,41,49,192,+
98,55,97,53,303,+
55,94,30,24,203,+
82,81,10,86,259,+
19,50,70,18,157,+
68,75,44,74,261,+
8,26,69,18,121,+
9,5,48,76,138,+
5,35,16,15,71,+
40,57,49,29,175,+
3,0,86,83,172,+
97,9,38,50,194,+
98,14,5,62,179,+
72,10,42,30,154,+
87,38,51,66,242,+
13,32,76,19,140,+
65,73,22,94,254,+
80,26,50,62,218,+
42,39,8,10,99,+
66,93,93,49,301,+
96,65,13,76,250,+
66,26,52,43,187,+
64,70,35,52,221,+
26,0,17,33,76,+
14,15,15,98,142,+
54,57,11,49,171,+
64,67,34,7,172,+
61,2,98,78,239,+
94,27,46,18,185,+
85,49,86,73,293,+
84,10,10,30,134,+
15,49,87,75,226,+
53,84,82,30,249,+
61,69,67,41,238,+
32,17,28,74,151,+
12,28,20,46,106,+
95,74,43,15,227,+
36,64,12,72,184,+
27,94,16,8,145,+
6,70,44,63,183,+
6,85,90,7,188,+
52,95,9,86,242,+
44,75,66,40,225,+
90,50,51,76,267,+
36,92,6,79,213,+
80,26,47,32,185,+
72,61,81,63,277,+
47,20,58,5,130,+
55,10,65,49,179,+
46,71,81,12,210,+
33,66,54,19,172,+
98,67,18,90,273,+
72,4,28,63,167,+
29,50,57,49,185,+
99,48,42,57,246,+
35,51,76,89,251,+
14,26,63,47,150,+
21,57,59,57,194,+
0,3,80,70,153,+
73,35,81,90,279,+
96,8,32,98,234,+
31,6,88,99,224,+
57,31,52,39,179,+
0,41,15,79,135,+
14,6,82,31,133,+
1,87,21,93,202,+
78,96,11,57,242,+
59,9,17,10,95,+
37,86,16,50,189,+
63,50,98,21,232,+
23,13,48,46,130,+
58,82,46,5,191,+
64,38,34,61,197,+
99,87,53,84,323,+
42,69,71,30,212,+
54,12,0,12,78,+
22,55,74,31,182,+
87,82,73,61,303,+
12,83,5,89,189,+
72,12,88,9,181,+
68,9,27,71,175,+
6,37,64,29,136,+
99,2,42,54,197,+
89,33,3,80,205,+
16,38,98,12,164,+
10,14,72,29,125,+
61,84,0,47,192,+
48,72,73,93,286,+
0,32,45,74,151,+
87,6,33,71,197,+
4,54,66,85,209,+
54,52,85,22,213,+
99,53,44,5,201,+
65,8,40,59,172,+
55,15,17,43,130,+
3,65,77,66,211,+
94,26,98,87,305,+
95,62,76,89,322,+
55,27,20,97,199,+
92,40,86,32,250,+
54,76,28,84,242,+
33,82,95,25,235,+
67,38,42,8,155,+
97,1,56,30,184,+
84,86,17,48,235,+
72,88,36,12,208,+
58,12,78,91,239,+
75,55,63,38,231,+
1,25,54,10,90,+
11,44,95,94,244,+
33,31,73,34,171,+
24,24,35,39,122,+
89,15,26,17,147,+
11,19,94,86,210,+
86,83,32,36,237,+
83,49,29,61,222,+
52,58,94,34,238,+
18,80,63,33,194,+
61,45,1,72,179,+
83,44,57,16,200,+
60,74,27,58,219,+
62,34,38,87,221,+
38,93,26,1,158,+
71,51,97,43,262,+
66,96,94,70,326,+
32,54,24,94,204,+
38,22,31,70,161,+
57,51,81,57,246,+
25,26,32,72,155,+
19,59,26,89,193,+
76,32,88,93,289,+
6,5,70,39,120,+
43,60,6,53,162,+
41,6,83,29,159,+
32,1,79,91,203,+
4,57,35,29,125,+
11,42,4,78,135,+
42,45,80,4,171,+
38,52,10,92,192,+
5,71,45,43,164,+
36,24,24,93,177,+
15,40,24,70,149,+
37,47,56,82,222,+
94,63,74,59,290,+
6,82,54,82,224,+
75,81,72,68,296,+
49,38,75,95,257,+
8,12,18,87,125,+
30,21,39,64,154,+
87,27,8,22,144,+
58,88,83,19,248,+
46,41,0,56,143,+
12,65,79,85,241,+
93,24,80,57,254,+
23,62,62,79,226,+
17,92,16,91,216,+
78,22,30,98,228,+
30,91,35,91,247,+
75,3,26,18,122,+
99,72,36,20,227,+
31,87,32,59,209,+
55,36,32,51,174,+
19,91,18,89,217,+
44,20,70,90,224,+
25,80,72,22,199,+
14,7,83,15,119,+
56,39,28,4,127,+
65,17,90,65,237,+
9,96,8,92,205,+
8,52,91,17,168,+
84,91,29,22,226,+
5,40,39,90,174,+
45,20,62,45,172,+
4,8,6,46,64,+
78,28,47,24,177,+
79,59,99,22,259,+
42,27,82,57,208,+
42,1,52,16,111,+
72,55,82,37,246,+
70,36,78,40,224,+
59,15,59,12,145,+
1,31,43,41,116,+
2,26,31,7,66,+
71,75,4,44,194,+
77,53,9,49,188,+
35,60,45,32,172,+
27,1,38,93,159,+
96,17,30,95,238,+
20,34,97,83,234,+
36,16,32,20,104,+
4,61,86,53,204,+
57,1,25,0,83,+
36,74,26,81,217,+
33,28,82,85,228,+
45,82,63,33,223,+
1,0,79,65,145,+
85,22,8,86,201,+
39,95,24,76,234,+
55,50,56,22,183,+
69,76,83,99,327,+
61,81,64,73,279,+
90,67,86,62,305,+
42,6,11,56,115,+
14,69,70,11,164,+
85,66,2,15,168,+
97,70,41,91,299,+
37,43,21,40,141,+
71,20,86,73,250,+
72,37,13,81,203,+
55,46,57,94,252,+
64,2,44,51,161,+
17,30,52,28,127,+
0,8,3,5,16,+
63,95,61,26,245,+
41,79,42,46,208,+
86,63,78,20,247,+
89,26,61,82,258,+
8,65,9,8,90,+
29,4,81,37,151,+
74,30,6,47,157,+
87,69,73,25,254,+
92,27,36,8,163,+
83,10,76,81,250,+
56,63,3,50,172,+
13,88,44,23,168,+
33,94,6,88,221,+
18,46,84,55,203,+
47,25,69,57,198,+
8,96,44,1,149,+
97,74,30,78,279,+
90,86,76,94,346,+
50,61,35,55,201,+
39,5,40,88,172,+
53,40,14,22,129,+
51,90,80,23,244,+
14,7,32,61,114,+
8,8,37,40,93,+
70,12,6,25,113,+
59,42,32,33,166,+
82,64,95,15,256,+
54,87,83,67,291,+
0,78,19,66,163,+
98,20,53,90,261,+
4,42,63,53,162,+
59,28,84,64,235,+
75,20,64,70,229,+
50,60,13,3,126,+
15,31,47,20,113,+
9,34,23,8,74,+
3,7,46,76,132,+
60,74,24,37,195,+
80,22,44,22,168,+
69,58,95,89,311,+
7,26,76,48,157,+
19,15,89,92,215,+
22,81,98,97,298,+
33,31,52,50,166,+
82,68,7,68,225,+
27,74,15,76,192,+
85,75,4,60,224,+
0,0,37,47,84,+
27,49,64,94,234,+
39,32,69,53,193,+
7,92,40,40,179,+
64,30,99,30,223,+
57,64,10,3,134,+
93,49,64,15,221,+
4,37,54,6,101,+
13,9,63,73,158,+
18,17,42,53,130,+
61,82,94,86,323,+
44,32,83,87,246,+
12,41,1,26,80,+
76,31,27,98,232,+
72,39,45,77,233,+
58,13,32,6,109,+
70,72,11,1,154,+
40,39,78,42,199,+
59,89,65,51,264,+
36,47,81,35,199,+
75,61,51,57,244,+
8,45,66,51,170,+
82,77,40,17,216,+
42,30,60,91,223,+
14,55,14,97,180,+
58,47,58,48,211,+
61,65,80,26,232,+
83,49,28,29,189,+
49,8,44,85,186,+
91,30,61,15,197,+
54,43,18,64,179,+
6,90,94,81,271,+
96,71,62,0,229,+
24,84,70,65,243,+
8,54,69,19,150,+
7,0,17,50,74,+
71,68,35,96,270,+
95,58,16,66,235,+
51,25,63,61,200,+
78,77,30,72,257,+
78,23,31,80,212,+
7,73,32,26,138,+
43,58,83,69,253,+
16,96,15,91,218,+
27,82,29,0,138,+
81,59,51,27,218,+
5,55,21,7,88,+
33,90,32,91,246,+
7,43,75,20,145,+
38,41,26,71,176,+
20,47,29,51,147,+
40,18,45,92,195,+
59,94,64,64,281,+
51,28,64,2,145,+
56,24,67,64,211,+
16,1,98,77,192,+
22,11,81,39,153,+
50,12,87,66,215,+
83,78,73,26,260,+
30,51,31,80,192,+
52,61,61,88,262,+
23,85,45,67,220,+
3,94,32,71,200,+
99,55,69,74,297,+
3,91,31,2,127,+
22,18,33,23,96,+
83,1,5,9,98,+
81,16,40,67,204,+
35,68,68,24,195,+
99,85,6,80,270,+
69,75,90,68,302,+
10,88,39,94,231,+
95,47,80,12,234,+
36,64,20,18,138,+
36,73,50,81,240,+
87,64,95,5,251,+
78,0,41,52,171,+
71,81,19,28,199,+
50,38,18,62,168,+
25,78,26,45,174,+
6,1,77,27,111,+
8,38,29,40,115,+
23,52,65,39,179,+
93,94,61,10,258,+
10,47,77,33,167,+
90,96,23,8,217,+
59,36,94,44,233,+
70,87,23,68,248,+
34,62,16,49,161,+
24,73,90,61,248,+
33,74,99,45,251,+
9,30,24,46,109,+
46,96,58,14,214,+
12,51,42,45,150,+
26,28,76,26,156,+
24,16,15,7,62,+
54,58,13,74,199,+
6,81,79,58,224,+
76,20,42,30,168,+
16,59,98,64,237,+
98,29,70,65,262,+
75,86,85,94,340,+
97,13,68,27,205,+
91,34,65,68,258,+
90,25,12,55,182,+
62,15,10,33,120,+
13,61,76,98,248,+
66,81,45,73,265,+
98,20,48,71,237,+
84,95,9,5,193,+
70,39,77,49,235,+
79,99,17,76,271,+
33,83,36,59,211,+
61,15,42,93,211,+
69,92,64,2,227,+
48,41,39,26,154,+
58,5,14,41,118,+
31,72,49,95,247,+
56,75,95,55,281,+
58,84,28,1,171,+
14,42,51,68,175,+
36,76,74,78,264,+
53,1,91,97,242,+
77,27,37,69,210,+
94,19,40,79,232,+
47,46,42,47,182,+
11,57,18,39,125,+
67,32,11,56,166,+
44,33,60,81,218,+
95,87,55,92,329,+
32,47,24,67,170,+
37,90,8,91,226,+
94,77,48,42,261,+
11,82,63,26,182,+
31,75,96,14,216,+
30,14,92,87,223,+
28,10,19,67,124,+
27,46,55,59,187,+
75,87,43,98,303,+
74,59,43,66,242,+
79,46,66,96,287,+
44,57,86,7,194,+
1,22,65,54,142,+
78,28,43,7,156,+
40,91,93,38,262,+
14,4,56,95,169,+
16,84,29,43,172,+
38,35,65,64,202,+
55,37,97,75,264,+
12,58,22,89,181,+
71,71,51,36,229,+
1,55,80,1,137,+
63,64,63,36,226,+
96,23,41,44,204,+
79,55,46,56,236,+
22,62,95,82,261,+
2,68,28,55,153,+
45,86,64,63,258,+
13,63,87,24,187,+
92,70,47,62,271,+
77,54,86,85,302,+
51,2,4,24,81,+
86,53,37,5,181,+
26,10,0,37,73,+
7,89,63,10,169,+
59,79,77,9,224,+
73,95,85,93,346,+
52,4,97,29,182,+
78,83,10,1,172,+
83,66,12,60,221,+
11,12,72,29,124,+
2,77,73,92,244,+
63,59,89,89,300,+
37,33,19,32,121,+
64,2,52,67,185,+
19,57,27,59,162,+
41,35,71,61,208,+
98,8,81,99,286,+
73,86,37,99,295,+
27,27,95,79,228,+
38,57,92,17,204,+
29,15,48,32,124,+
55,90,50,4,199,+
88,97,14,5,204,+
59,30,80,43,212,+
35,22,55,91,203,+
72,4,43,98,217,+
88,49,75,24,236,+
96,76,28,43,243,+
6,8,44,75,133,+
16,90,91,36,233,+
3,66,87,65,221,+
55,96,85,13,249,+
50,76,32,38,196,+
51,83,59,39,232,+
62,1,59,82,204,+
15,85,10,40,150,+
97,67,29,86,279,+
29,74,69,48,220,+
74,69,55,16,214,+
55,30,85,34,204,+
39,61,64,13,177,+
21,28,71,50,170,+
55,96,27,31,209,+
10,37,24,68,139,+
0,10,6,51,67,+
28,73,11,1,113,+
17,0,20,25,62,+
37,75,75,53,240,+
68,64,58,54,244,+
55,0,81,93,229,+
34,41,50,93,218,+
37,22,66,8,133,+
51,20,43,67,181,+
53,38,65,30,186,+
74,7,47,72,200,+
99,11,3,15,128,+
31,97,69,41,238,+
27,44,40,57,168,+
30,78,78,51,237,+
26,18,87,15,146,+
47,29,30,79,185,+
20,35,83,33,171,+
26,77,68,30,201,+
95,7,16,6,124,+
62,54,71,99,286,+
74,44,81,86,285,+
97,82,12,13,204,+
23,26,91,4,144,+
2,3,26,95,126,+
75,85,18,11,189,+
44,32,90,10,176,+
22,83,37,76,218,+
38,77,15,21,151,+
67,15,30,3,115,+
45,49,90,40,224,+
55,94,77,95,321,+
84,38,88,35,245,+
54,68,60,46,228,+
48,22,46,96,212,+
67,1,37,29,134,+
62,35,68,55,220,+
38,36,4,35,113,+
98,97,38,62,295,+
30,53,45,21,149,+
11,7,10,92,120,+
61,68,21,32,182,+
37,12,1,18,68,+
2,26,17,84,129,+
60,69,18,90,237,+
92,1,37,82,212,+
70,95,54,70,289,+
15,31,19,62,127,+
51,73,80,23,227,+
12,82,7,25,126,+
97,9,90,10,206,+
87,18,96,37,238,+
30,8,34,2,74,+
79,77,12,84,252,+
30,44,14,51,139,+
34,96,76,26,232,+
42,52,30,83,207,+
21,39,18,43,121,+
82,46,95,45,268,+
62,87,21,37,207,+
41,66,69,8,184,+
39,49,34,16,138,+
58,85,62,43,248,+
18,36,20,76,150,+
30,8,78,99,215,+
54,42,93,36,225,+
96,70,84,3,253,+
23,37,30,19,109,+
27,11,94,5,137,+
99,26,99,66,290,+
73,44,15,75,207,+
64,33,66,49,212,+
51,22,86,39,198,+
59,95,65,89,308,+
85,43,55,29,212,+
50,62,23,68,203,+
25,7,15,28,75,+
40,11,27,40,118,+
90,33,36,29,188,+
46,56,12,85,199,+
91,59,13,61,224,+
22,80,69,55,226,+
45,13,14,58,130,+
97,0,6,49,152,+
25,96,43,62,226,+
93,48,25,4,170,+
44,3,12,96,155,+
62,62,0,56,180,+
23,59,38,7,127,+
4,31,45,30,110,+
82,66,79,14,241,+
17,59,50,48,174,+
2,40,2,78,122,+
97,50,44,37,228,+
71,21,59,31,182,+
10,67,60,97,234,+
60,64,51,56,231,+
32,91,81,13,217,+
91,62,61,47,261,+
6,29,78,27,140,+
85,21,23,60,189,+
81,3,11,92,187,+
87,61,10,57,215,+
9,48,2,41,100,+
96,36,56,12,200,+
27,89,95,73,284,+
6,0,44,3,53,+
12,88,89,31,220,+
57,8,48,79,192,+
38,58,91,23,210,+
36,33,75,14,158,+
75,26,65,53,219,+
42,53,20,95,210,+
31,23,41,36,131,+
6,38,76,31,151,+
32,86,74,20,212,+
56,65,94,62,277,+
52,27,38,57,174,+
76,62,37,42,217,+
74,19,9,11,113,+
86,87,63,37,273,+
84,76,32,11,203,+
16,48,15,4,83,+
72,18,6,63,159,+
54,8,8,42,112,+
36,58,79,81,254,+
82,64,20,88,254,+
43,6,4,0,53,+
71,54,90,49,264,+
99,1,73,82,255,+
52,49,36,80,217,+
48,0,35,48,131,+
77,2,25,16,120,+
88,39,4,47,178,+
74,90,72,88,324,+
71,80,25,40,216,+
99,87,51,51,288,+
33,6,73,57,169,+
84,93,92,62,331,+
33,24,43,17,117,+
5,59,51,64,179,+
80,17,84,39,220,+
5,77,48,47,177,+
88,40,50,26,204,+
3,55,10,67,135,+
26,71,21,40,158,+
99,74,38,53,264,+
61,14,59,39,173,+
32,49,23,17,121,+
39,85,33,92,249,+
31,56,47,67,201,+
67,87,23,9,186,+
30,28,88,54,200,+
88,16,99,24,227,+
95,8,59,0,162,+
93,58,75,63,289,+
23,59,44,89,215,+
12,2,79,50,143,+
22,55,66,80,223,+
22,39,50,2,113,+
15,84,5,43,147,+
10,22,70,13,115,+
48,57,3,95,203,+
94,59,15,34,202,+
9,69,13,63,154,+
36,8,94,14,152,+
82,45,43,96,266,+
97,37,8,2,144,+
91,9,30,11,141,+
22,58,63,66,209,+
59,31,62,67,219,+
60,71,62,86,279,+
45,47,22,69,183,+
17,49,3,27,96,+
98,12,2,43,155,+
1,10,86,11,108,+
73,33,81,97,284,+
92,68,56,7,223,+
22,30,31,61,144,+
35,11,88,97,231,+
75,26,84,23,208,+
90,16,4,14,124,+
20,27,26,11,84,+
50,60,25,24,159,+
51,97,21,54,223,+
86,12,82,18,198,+
67,1,4,84,156,+
84,8,88,98,278,+
41,44,56,45,186,+
61,93,63,77,294,+
70,65,51,50,236,+
78,8,12,16,114,+
22,3,51,16,92,+
61,66,82,34,243,+
63,97,7,21,188,+
15,82,87,98,282,+
63,34,94,44,235,+
56,36,36,12,140,+
50,10,11,0,71,+
35,52,31,98,216,+
18,22,74,7,121,+
66,68,93,55,282,+
46,78,60,44,228,+
74,2,50,52,178,+
24,71,47,57,199,+
54,99,80,81,314,+
40,19,80,92,231,+
73,77,11,13,174,+
29,32,48,97,206,+
32,70,79,59,240,+
91,33,53,61,238,+
52,26,89,10,177,+
88,7,86,48,229,+
17,8,53,14,92,+
75,40,78,60,253,+
71,24,91,42,228,+
95,87,62,83,327,+
77,17,30,23,147,+
40,98,94,57,289,+
1,22,87,84,194,+
68,59,54,51,232,+
98,44,92,76,310,+
44,51,75,3,173,+
88,19,26,59,192,+
75,3,7,77,162,+
55,99,25,44,223,+
17,49,14,43,123,+
14,60,32,29,135,+
57,1,68,90,216,+
35,59,83,77,254,+
56,36,18,17,127,+
21,95,44,46,206,+
54,61,36,80,231,+
50,64,89,36,239,+
20,57,20,21,118,+
55,52,22,9,138,+
70,27,52,66,215,+
66,37,0,4,107,+
10,3,12,69,94,+
0,13,69,44,126,+
94,63,86,41,284,+
25,28,95,98,246,+
98,64,69,39,270,+
52,99,26,14,191,+
3,2,89,29,123,+
90,29,50,41,210,+
3,78,85,6,172,+
17,28,5,79,129,+
5,9,81,11,106,+
55,59,18,72,204,+
62,41,53,97,253,+
59,26,80,21,186,+
56,1,5,84,146,+
79,97,50,86,312,+
37,22,32,55,146,+
78,6,37,69,190,+
21,54,11,19,105,+
38,84,60,60,242,+
31,76,72,45,224,+
15,69,71,57,212,+
59,22,71,2,154,+
12,90,47,92,241,+
31,19,20,17,87,+
66,79,68,11,224,+
2,52,40,7,101,+
3,45,73,21,142,+
60,98,12,40,210,+
9,61,51,92,213,+
59,94,96,5,254,+
36,75,51,15,177,+
40,86,80,18,224,+
13,27,51,54,145,+
44,61,10,11,126,+
77,42,48,83,250,+
75,69,63,38,245,+
23,61,80,37,201,+
36,1,52,88,177,+
35,26,93,91,245,+
99,72,54,30,255,+
4,59,86,31,180,+
22,49,67,27,165,+
84,53,34,63,234,+
45,59,77,0,181,+
50,16,70,49,185,+
46,34,7,79,166,+
33,84,50,93,260,+
46,80,85,87,298,+
98,83,81,76,338,+
16,68,30,24,138,+
18,52,92,24,186,+
45,42,61,77,225,+
6,0,72,91,169,+
22,29,35,29,115,+
2,94,82,44,222,+
67,81,50,59,257,+
51,46,10,5,112,+
81,53,61,30,225,+
94,12,35,8,149,+
6,89,53,4,152,+
32,67,56,56,211,+
37,63,76,89,265,+
67,69,80,15,231,+
20,3,35,86,144,+
77,99,21,22,219,+
52,17,34,18,121,+
2,88,95,83,268,+
18,69,46,36,169,+
63,47,59,56,225,+
48,0,23,91,162,+
34,61,35,32,162,+
41,41,5,73,160,+
25,76,12,64,177,+
75,29,75,26,205,+
44,99,13,1,157,+
76,47,4,92,219,+
81,14,41,58,194,+
6,74,88,78,246,+
98,70,80,80,328,+
38,46,98,93,275,+
88,14,85,30,217,+
12,40,8,38,98,+
65,77,38,27,207,+
62,92,82,79,315,+
95,74,82,89,340,+
59,59,95,60,273,+
81,87,72,4,244,+
24,37,96,7,164,+
26,32,6,24,88,+
35,98,17,88,238,+
99,40,81,50,270,+
49,39,74,85,247,+
39,5,79,18,141,+
53,21,1,10,85,+
69,42,33,48,192,+
97,25,81,4,207,+
6,71,54,57,188,+
70,50,85,80,285,+
61,88,65,36,250,+
32,16,57,56,161,+
98,35,59,57,249,+
47,97,9,45,198,+
25,52,59,31,167,+
91,54,19,74,238,+
20,28,86,5,139,+
69,58,76,95,298,+
76,87,63,5,231,+
14,90,42,48,194,+
41,79,71,43,234,+
60,23,58,77,218,+
84,79,26,29,218,+
17,26,2,38,83,+
29,13,66,80,188,+
96,58,38,96,288,+
18,49,3,9,79,+
54,47,72,12,185,+
92,31,77,93,293,+
27,79,45,86,237,+
5,84,33,49,171,+
36,22,36,92,186,+
68,40,68,24,200,+
82,55,41,8,186,+
35,19,75,1,130,+
57,98,45,93,293,+
71,69,9,51,200,+
34,89,80,49,252,+
9,63,64,27,163,+
48,34,23,53,158,+
35,94,88,38,255,+
67,82,50,43,242,+
70,83,8,82,243,+
47,18,34,16,115,+
46,38,19,12,115,+
13,16,87,54,170,+
36,33,39,14,122,+
64,16,23,12,115,+
14,65,90,47,216,+
67,38,89,38,232,+
78,48,53,27,206,+
6,44,38,33,121,+
10,60,58,50,178,+
82,62,26,85,255,+
34,29,90,31,184,+
40,9,36,42,127,+
90,98,92,78,358,+
34,28,14,7,83,+
15,5,50,65,135,+
21,42,58,53,174,+
94,19,74,44,231,+
73,79,37,31,220,+
95,71,77,4,247,+
81,65,8,3,157,+
6,25,13,31,75,+
74,77,46,47,244,+
70,79,26,75,250,+
71,80,79,32,262,+
33,46,68,22,169,+
22,95,95,56,268,+
34,40,60,21,155,+
92,67,28,13,200,+
65,39,35,44,183,+
82,72,93,38,285,+
7,37,59,59,162,+
54,30,20,2,106,+
72,33,40,56,201,+
48,62,38,30,178,+
74,84,37,56,251,+
61,99,51,10,221,+
53,71,37,36,197,+
81,82,98,30,291,+
5,20,66,32,123,+
5,10,53,88,156,+
99,1,68,85,253,+
82,80,28,86,276,+
56,6,29,81,172,+
57,90,20,62,229,+
42,79,87,48,256,+
42,2,59,32,135,+
70,77,64,94,305,+
38,21,5,95,159,+
4,47,89,9,149,+
44,56,17,0,117,+
40,23,35,41,139,+
43,96,19,26,184,+
63,14,90,94,261,+
99,63,73,59,294,+
24,33,78,40,175,+
7,46,22,23,98,+
36,18,53,5,112,+
67,95,68,28,258,+
11,76,13,65,165,+
63,11,89,45,208,+
58,7,11,43,119,+
47,44,22,97,210,+
94,47,79,80,300,+
15,81,75,61,232,+
88,31,29,42,190,+
60,11,23,83,177,+
85,98,66,35,284,+
91,47,89,50,277,+
39,4,72,40,155,+
30,84,48,1,163,+
57,41,29,85,212,+
98,17,61,18,194,+
47,61,1,41,150,+
80,25,35,82,222,+
8,62,92,60,222,+
81,55,7,56,199,+
50,28,56,20,154,+
4,34,92,52,182,+
86,20,16,34,156,+
96,88,50,28,262,+
23,2,26,12,63,+
63,40,75,14,192,+
32,94,27,61,214,+
36,55,14,82,187,+
61,25,81,78,245,+
42,22,82,12,158,+
13,17,58,68,156,+
50,13,40,66,169,+
67,88,59,10,224,+
21,78,67,18,184,+
53,22,77,78,230,+
13,64,40,91,208,+
64,72,97,17,250,+
97,39,0,48,184,+
84,4,4,75,167,+
40,3,38,2,83,+
42,28,22,67,159,+
72,81,67,55,275,+
84,98,46,20,248,+
77,43,46,74,240,+
38,44,7,51,140,+
86,6,37,80,209,+
68,53,13,67,201,+
58,64,5,73,200,+
75,16,18,28,137,+
87,36,64,88,275,+
5,52,46,30,133,+
37,15,2,17,71,+
96,44,94,78,312,+
16,13,32,94,155,+
90,55,96,24,265,+
32,9,48,48,137,+
51,93,56,14,214,+
31,59,69,6,165,+
15,96,31,30,172,+
62,14,61,17,154,+
69,64,94,52,279,+
7,43,14,76,140,+
18,24,53,20,115,+
41,42,55,12,150,+
81,33,14,69,197,+
50,61,9,92,212,+
20,25,83,87,215,+
11,9,54,40,114,+
7,69,51,23,150,+
72,40,76,92,280,+
15,15,64,60,154,+
4,92,73,15,184,+
58,96,26,1,181,+
27,84,17,31,159,+
69,30,59,50,208,+
16,10,57,42,125,+
45,16,10,76,147,+
85,15,51,32,183,+
0,22,54,79,155,+
7,47,13,69,136,+
13,57,83,1,154,+
77,63,48,90,278,+
25,1,41,27,94,+
84,40,1,72,197,+
70,36,97,45,248,+
43,64,39,24,170,+
98,10,66,91,265,+
47,56,67,15,185,+
82,54,96,43,275,+
2,65,57,66,190,+
17,8,9,94,128,+
28,49,56,3,136,+
6,72,64,65,207,+
42,17,0,87,146,+
59,32,71,27,189,+
77,65,17,42,201,+
2,67,13,67,149,+
93,54,60,28,235,+
75,74,29,39,217,+
46,45,64,56,211,+
75,40,37,21,173,+
51,32,54,92,229,+
48,92,80,10,230,+
23,88,77,77,265,+
17,43,27,38,125,+
97,86,81,50,314,+
8,88,9,4,109,+
0,25,84,6,115,+
5,48,23,47,123,+
24,10,87,13,134,+
88,18,69,4,179,+
65,93,68,17,243,+
87,74,76,86,323,+
36,47,43,88,214,+
46,85,64,74,269,+
12,73,57,82,224,+
73,31,9,9,122,+
84,86,1,6,177,+
95,0,29,49,173,+
76,13,77,85,251,+
94,90,73,26,283,+
11,84,24,58,177,+
69,17,79,56,221,+
41,56,74,7,178,+
24,89,10,56,179,+
55,77,66,96,294,+
22,45,49,11,127,+
94,83,27,65,269,+
52,92,41,99,284,+
30,33,21,93,177,+
47,86,31,54,218,+
82,93,11,42,228,+
73,20,2,64,159,+
2,16,61,84,163,+
7,65,1,53,126,+
21,35,18,74,148,+
62,44,26,95,227,+
56,41,94,96,287,+
11,49,88,66,214,+
4,0,64,93,161,+
26,32,14,49,121,+
30,11,41,35,117,+
91,84,17,20,212,+
25,8,61,51,145,+
59,10,2,33,104,+
73,6,37,58,174,+
14,2,96,2,114,+
83,27,24,49,183,+
48,47,56,58,209,+
51,27,51,87,216,+
64,1,34,15,114,+
16,48,43,56,163,+
78,54,98,71,301,+
39,72,57,22,190,+
28,41,18,96,183,+
48,79,51,36,214,+
82,19,31,20,152,+
17,96,96,40,249,+
89,92,21,18,220,+
83,68,3,87,241,+
81,14,81,14,190,+
28,13,57,78,176,+
75,95,49,2,221,+
90,21,99,64,274,+
85,64,55,28,232,+
48,88,56,0,192,+
14,93,28,67,202,+
86,60,2,84,232,+
4,17,57,19,97,+
80,20,36,17,153,+
73,77,84,76,310,+
20,13,88,42,163,+
90,40,85,61,276,+
95,31,53,87,266,+
60,0,21,49,130,+
89,74,77,51,291,+
29,92,83,68,272,+
61,29,46,88,224,+
56,73,65,41,235,+
99,18,96,53,266,+
89,68,29,1,187,+
34,77,39,40,190,+
40,47,13,17,117,+
89,87,11,13,200,+
34,72,91,65,262,+
22,97,32,56,207,+
12,60,45,81,198,+
76,29,29,9,143,+
86,20,72,0,178,+
52,79,57,77,265,+
8,46,95,58,207,+
93,27,83,69,272,+
45,50,16,17,128,+
96,79,80,95,350,+
24,67,91,93,275,+
31,43,14,85,173,+
66,87,32,34,219,+
6,98,47,83,234,+
1,99,12,89,201,+
73,62,23,48,206,+
0,91,9,88,188,+
46,75,63,85,269,+
87,1,29,22,139,+
48,59,71,94,272,+
78,62,79,12,231,+
36,58,39,14,147,+
9,62,95,1,167,+
48,22,88,24,182,+
99,47,95,61,302,+
68,6,84,55,213,+
50,15,31,70,166,+
62,63,28,18,171,+
7,99,6,49,161,+
68,96,89,78,331,+
35,16,6,11,68,+
44,76,2,91,213,+
4,13,65,15,97,+
52,82,58,6,198,+
26,66,83,24,199,+
33,17,25,92,167,+
56,46,41,45,188,+
62,74,6,42,184,+
27,38,15,65,145,+
33,98,48,88,267,+
56,90,25,49,220,+
15,26,19,5,65,+
64,95,67,78,304,+
15,75,12,68,170,+
13,7,93,57,170,+
50,41,82,22,195,+
29,92,76,91,288,+
57,76,77,90,300,+
93,11,9,74,187,+
18,28,86,42,174,+
33,8,14,52,107,+
60,11,51,37,159,+
57,0,70,91,218,+
15,29,77,58,179,+
39,20,76,0,135,+
25,56,84,31,196,+
90,83,92,24,289,+
67,76,51,42,236,+
37,95,54,21,207,+
97,47,47,58,249,+
89,15,78,42,224,+
85,74,11,51,221,+
38,57,61,1,157,+
89,33,62,0,184,+
12,70,59,26,167,+
36,86,50,31,203,+
58,89,0,69,216,+
35,37,14,19,105,+
49,41,78,92,260,+
27,50,80,57,214,+
91,66,52,54,263,+
11,42,85,72,210,+
79,10,43,10,142,+
44,16,70,20,150,+
74,71,1,85,231,+
59,5,50,70,184,+
2,26,25,96,149,+
95,39,74,48,256,+
0,44,40,76,160,+
90,5,57,81,233,+
25,23,63,77,188,+
48,72,44,30,194,+
36,58,58,62,214,+
43,26,14,27,110,+
51,76,74,95,296,+
9,84,58,63,214,+
83,67,73,80,303,+
59,15,59,8,141,+
13,11,9,59,92,+
66,58,25,75,224,+
9,74,71,79,233,+
94,22,16,69,201,+
12,49,36,52,149,+
37,86,70,32,225,+
63,57,29,93,242,+
16,53,15,81,165,+
87,24,52,7,170,+
89,89,41,82,301,+
6,77,18,99,200,+
91,27,43,71,232,+
58,51,9,84,202,+
49,31,52,6,138,+
41,67,42,65,215,+
64,57,35,70,226,+
3,8,20,71,102,+
75,75,62,75,287,+
48,61,1,8,118,+
82,38,69,54,243,+
4,67,97,58,226,+
35,60,28,8,131,+
49,37,83,60,229,+
30,71,38,73,212,+
2,57,81,62,202,+
71,17,43,95,226,+
22,2,36,87,147,+
64,35,33,31,163,+
2,24,16,48,90,+
35,95,38,34,202,+
40,8,14,9,71,+
24,4,44,41,113,+
28,82,81,46,237,+
30,5,59,73,167,+
10,98,73,49,230,+
54,11,9,20,94,+
29,7,55,66,157,+
52,86,4,92,234,+
14,97,97,60,268,+
23,46,67,55,191,+
64,16,59,60,199,+
72,77,52,52,253,+
62,85,36,84,267,+
26,52,90,87,255,+
74,39,78,52,243,+
45,70,19,65,199,+
25,54,87,68,234,+
82,77,76,80,315,+
90,65,80,15,250,+
59,40,34,31,164,+
88,6,80,78,252,+
26,54,34,89,203,+
72,75,14,47,208,+
93,45,30,26,194,+
64,61,24,37,186,+
56,48,14,5,123,+
18,83,76,31,208,+
59,55,34,96,244,+
58,30,27,19,134,+
96,83,1,17,197,+
81,33,97,41,252,+
12,92,29,13,146,+
89,79,82,83,333,+
59,32,96,48,235,+
75,21,97,73,266,+
54,57,80,37,228,+
81,90,4,28,203,+
84,12,24,71,191,+
95,16,0,27,138,+
56,0,74,14,144,+
95,54,7,51,207,+
69,56,71,1,197,+
67,62,21,92,242,+
46,71,31,79,227,+
8,68,3,72,151,+
30,16,65,16,127,+
99,13,84,76,272,+
81,89,16,24,210,+
74,73,39,95,281,+
44,61,91,28,224,+
92,64,61,66,283,+
23,56,56,88,223,+
80,61,16,74,231,+
87,94,3,93,277,+
45,77,24,27,173,+
69,21,11,64,165,+
4,16,67,11,98,+
60,74,61,28,223,+
24,62,83,29,198,+
45,72,88,44,249,+
0,42,44,65,151,+
32,88,73,11,204,+
17,0,83,61,161,+
47,90,55,8,200,+
26,2,3,22,53,+
74,28,11,62,175,+
95,23,82,42,242,+
76,79,0,86,241,+
23,46,28,28,125,+
80,56,41,51,228,+
88,39,25,48,200,+
16,27,62,59,164,+
67,24,11,46,148,+
50,77,63,87,277,+
26,64,85,5,180,+
54,4,49,3,110,+
73,27,92,47,239,+
46,99,1,15,161,+
59,74,8,56,197,+
24,36,8,82,150,+
29,87,92,62,270,+
49,26,86,54,215,+
54,99,17,42,212,+
86,18,82,13,199,+
54,67,31,8,160,+
72,97,34,75,278,+
50,20,29,85,184,+
23,44,96,60,223,+
2,67,26,60,155,+
2,60,58,27,147,+
29,82,69,99,279,+
42,52,79,20,193,+
64,6,94,16,180,+
36,50,24,22,132,+
1,99,72,28,200,+
43,90,88,41,262,+
74,46,77,38,235,+
88,32,78,62,260,+
91,54,80,63,288,+
64,86,71,11,232,+
13,26,13,93,145,+
81,94,57,16,248,+
67,36,70,23,196,+
27,47,98,37,209,+
7,82,42,68,199,+
91,43,33,11,178,+
65,83,62,35,245,+
2,63,27,1,93,+
30,4,17,98,149,+
75,22,86,82,265,+
26,63,46,27,162,+
23,7,61,75,166,+
55,47,10,26,138,+
88,12,65,29,194,+
36,7,77,35,155,+
89,36,71,80,276,+
76,78,86,90,330,+
69,38,93,44,244,+
37,75,37,97,246,+
76,57,67,37,237,+
9,91,31,25,156,+
4,82,62,39,187,+
26,16,51,65,158,+
8,53,1,46,108,+
75,1,42,48,166,+
56,37,46,0,139,+
69,63,19,98,249,+
3,48,35,29,115,+
75,11,31,59,176,+
33,61,87,41,222,+
32,28,38,5,103,+
48,84,0,79,211,+
49,15,8,63,135,+
26,19,47,5,97,+
49,99,62,34,244,+
97,24,98,63,282,+
13,7,87,45,152,+
76,38,56,53,223,+
50,39,48,40,177,+
31,26,19,75,151,+
65,0,31,82,178,+
1,0,51,62,114,+
88,64,91,4,247,+
91,62,55,54,262,+
23,26,3,74,126,+
73,22,77,47,219,+
47,19,42,86,194,+
27,41,78,4,150,+
3,21,42,20,86,+
38,14,61,96,209,+
43,78,24,20,165,+
87,78,13,54,232,+
39,89,92,45,265,+
9,35,40,64,148,+
2,64,52,18,136,+
72,57,31,41,201,+
76,90,61,93,320,+
0,3,34,13,50,+
54,22,91,94,261,+
73,86,47,26,232,+
45,51,11,51,158,+
30,99,66,2,197,+
15,47,44,66,172,+
78,37,46,84,245,+
18,60,89,17,184,+
12,13,81,54,160,+
19,78,99,74,270,+
88,38,71,49,246,+
83,22,45,12,162,+
46,58,3,83,190,+
14,80,68,42,204,+
0,57,79,86,222,+
96,56,54,7,213,+
71,47,66,59,243,+
20,77,65,32,194,+
71,5,3,17,96,+
69,65,79,57,270,+
85,40,89,94,308,+
92,75,63,64,294,+
0,23,28,57,108,+
0,4,6,57,67,+
21,26,64,78,189,+
53,12,79,1,145,+
63,2,74,59,198,+
72,21,9,46,148,+
20,6,34,96,156,+
14,17,15,23,69,+
59,92,42,70,263,+
43,63,25,17,148,+
11,75,46,24,156,+
77,93,47,3,220,+
84,30,95,2,211,+
61,17,17,29,124,+
4,81,62,57,204,+
25,16,90,86,217,+
86,12,3,94,195,+
87,68,39,70,264,+
24,91,73,86,274,+
95,85,34,20,234,+
54,87,37,47,225,+
91,96,33,50,270,+
90,75,41,76,282,+
12,25,75,96,208,+
28,83,51,58,220,+
97,15,52,14,178,+
26,38,2,88,154,+
32,22,13,4,71,+
96,17,43,90,246,+
26,44,31,5,106,+
27,75,51,22,175,+
18,35,98,68,219,+
76,79,42,89,286,+
14,8,60,45,127,+
30,70,67,70,237,+
19,79,89,45,232,+
75,44,48,38,205,+
54,48,71,61,234,+
44,54,8,55,161,+
20,42,2,85,149,+
55,21,40,21,137,+
7,57,89,51,204,+
14,75,1,63,153,+
53,10,77,33,173,+
54,65,50,76,245,+
83,33,21,88,225,+
2,9,97,18,126,+
95,13,52,87,247,+
49,39,98,1,187,+
14,46,87,43,190,+
21,10,34,25,90,+
89,13,75,0,177,+
35,46,39,8,128,+
31,6,62,7,106,+
64,46,27,38,175,+
35,57,37,83,212,+
96,38,64,89,287,+
93,97,0,19,209,+
64,37,68,20,189,+
37,23,93,74,227,+
89,54,4,84,231,+
63,68,52,27,210,+
90,37,88,74,289,+
49,86,12,31,178,+
50,77,80,15,222,+
63,48,2,30,143,+
83,70,75,51,279,+
85,64,71,3,223,+
65,48,24,99,236,+
1,35,15,51,102,+
30,66,54,93,243,+
10,47,93,31,181,+
50,56,14,80,200,+
33,12,88,65,198,+
20,2,3,48,73,+
4,76,18,7,105,+
82,34,36,74,226,+
66,23,67,25,181,+
74,68,2,36,180,+
32,90,47,40,209,+
45,65,55,46,211,+
1,85,60,83,229,+
3,73,30,96,202,+
52,95,64,91,302,+
15,58,76,98,247,+
92,60,18,95,265,+
71,79,65,83,298,+
17,73,78,24,192,+
74,92,38,42,246,+
28,91,74,43,236,+
99,80,21,78,278,+
87,5,34,22,148,+
68,50,87,26,231,+
81,56,58,84,279,+
36,28,3,92,159,+
54,66,84,55,259,+
96,39,81,16,232,+
81,16,96,56,249,+
59,31,80,5,175,+
24,63,32,6,125,+
64,47,29,83,223,+
90,80,69,54,293,+
75,17,62,98,252,+
85,51,54,60,250,+
88,32,85,53,258,+
31,92,16,46,185,+
12,99,63,34,208,+
32,0,47,15,94,+
98,2,51,50,201,+
92,90,94,44,320,+
11,67,49,83,210,+
30,0,38,56,124,+
95,6,69,64,234,+
68,18,10,56,152,+
92,53,53,88,286,+
85,56,91,27,259,+
80,36,36,55,207,+
46,25,83,32,186,+
60,32,20,52,164,+
45,39,14,80,178,+
41,71,68,26,206,+
26,86,59,23,194,+
60,24,89,52,225,+
15,96,61,25,197,+
14,46,93,31,184,+
60,3,7,6,76,+
57,56,83,22,218,+
30,4,18,94,146,+
1,47,68,56,172,+
27,48,75,77,227,+
75,56,61,43,235,+
99,51,80,73,303,+
1,19,50,7,77,+
53,63,85,11,212,+
25,94,51,81,251,+
60,32,70,93,255,+
9,24,82,86,201,+
63,81,81,36,261,+
81,9,82,68,240,+
77,63,55,74,269,+
56,31,34,60,181,+
35,62,43,34,174,+
25,19,54,29,127,+
10,53,45,80,188,+
7,24,63,46,140,+
90,38,44,64,236,+
71,50,55,9,185,+
32,49,54,18,153,+
38,95,85,46,264,+
93,27,28,10,158,+
49,87,90,88,314,+
25,81,82,31,219,+
26,54,55,62,197,+
36,97,97,22,252,+
71,8,64,96,239,+
64,87,81,57,289,+
82,60,35,86,263,+
97,91,36,80,304,+
54,6,27,3,90,+
81,5,27,76,189,+
40,71,42,63,216,+
77,2,64,30,173,+
70,37,93,80,280,+
43,55,36,75,209,+
6,44,61,92,203,+
65,46,7,60,178,+
22,1,24,11,58,+
32,76,52,61,221,+
52,73,17,0,142,+
41,11,7,67,126,+
3,61,87,26,177,+
51,56,11,98,216,+
92,6,96,83,277,+
90,86,55,87,318,+
95,72,72,45,284,+
28,38,28,51,145,+
73,86,10,95,264,+
30,87,64,3,184,+
82,1,50,67,200,+
50,75,48,81,254,+
4,85,63,80,232,+
36,56,14,76,182,+
77,50,79,93,299,+
44,86,11,80,221,+
64,96,49,43,252,+
97,6,74,85,262,+
99,19,71,61,250,+
5,80,20,5,110,+
94,63,24,61,242,+
12,30,37,20,99,+
56,21,58,46,181,+
26,86,40,1,153,+
72,41,64,74,251,+
5,30,31,51,117,+
51,66,31,63,211,+
67,41,78,2,188,+
19,45,40,28,132,+
35,38,36,50,159,+
41,80,97,42,260,+
18,25,24,1,68,+
73,22,55,12,162,+
96,90,18,67,271,+
36,49,18,24,127,+
11,65,15,39,130,+
72,88,40,4,204,+
67,46,45,2,160,+
62,63,4,50,179,+
35,97,6,10,148,+
0,25,62,79,166,+
45,96,60,23,224,+
96,40,34,41,211,+
73,76,82,46,277,+
69,12,53,30,164,+
59,46,45,22,172,+
14,65,94,83,256,+
9,46,49,17,121,+
40,92,57,89,278,+
83,21,89,48,241,+
94,34,64,4,196,+
76,84,35,53,248,+
31,49,43,57,180,+
59,7,72,97,235,+
45,34,55,47,181,+
89,64,54,80,287,+
3,4,62,97,166,+
17,1,5,70,93,+
5,38,52,22,117,+
98,81,4,8,191,+
10,93,40,4,147,+
57,15,51,60,183,+
4,12,41,77,134,+
25,1,9,98,133,+
25,2,45,36,108,+
50,68,68,78,264,+
14,66,19,36,135,+
65,4,69,10,148,+
78,87,93,25,283,+
72,64,74,43,253,+
65,82,9,74,230,+
44,35,62,46,187,+
8,26,3,79,116,+
35,58,98,9,200,+
56,9,62,77,204,+
52,4,91,77,224,+
71,35,19,57,182,+
24,13,2,33,72,+
38,89,75,32,234,+
44,5,39,60,148,+
69,81,37,6,193,+
26,44,89,14,173,+
74,34,30,42,180,+
50,48,23,87,208,+
69,5,81,57,212,+
19,47,61,10,137,+
74,96,20,92,282,+
53,71,12,26,162,+
49,55,8,93,205,+
14,83,73,60,230,+
86,91,62,84,323,+
71,88,33,53,245,+
20,83,43,54,200,+
55,82,7,38,182,+
23,68,79,60,230,+
47,46,57,18,168,+
41,30,93,95,259,+
35,93,77,84,289,+
85,84,3,81,253,+
56,47,61,34,198,+
30,56,5,54,145,+
26,56,95,44,221,+
74,73,34,65,246,+
56,12,84,22,174,+
32,61,47,32,172,+
92,84,13,90,279,+
74,23,18,61,176,+
5,99,14,92,210,+
39,44,89,14,186,+
38,51,15,85,189,+
31,30,89,72,222,+
85,88,42,26,241,+
98,2,49,13,162,+
62,6,71,68,207,+
91,19,32,42,184,+
1,57,73,81,212,+
6,94,29,21,150,+
37,52,11,18,118,+
43,12,29,48,132,+
70,57,66,19,212,+
98,23,53,43,217,+
31,34,41,57,163,+
47,39,90,8,184,+
70,16,9,13,108,+
76,83,22,35,216,+
1,75,96,59,231,+
7,59,43,67,176,+
21,58,22,1,102,+
1,30,10,90,131,+
57,99,6,19,181,+
53,5,25,94,177,+
70,67,97,23,257,+
65,86,83,36,270,+
79,17,59,5,160,+
17,13,26,19,75,+
40,87,95,11,233,+
57,92,19,31,199,+
30,72,41,54,197,+
2,88,5,30,125,+
91,96,22,33,242,+
6,33,19,50,108,+
51,72,30,28,181,+
63,45,66,2,176,+
84,64,44,26,218,+
27,80,15,26,148,+
5,96,98,25,224,+
55,44,80,5,184,+
70,74,99,51,294,+
45,53,51,84,233,+
82,39,28,39,188,+
87,22,31,18,158,+
4,18,18,77,117,+
90,90,42,57,279,+
53,49,13,38,153,+
58,53,53,97,261,+
39,88,79,87,293,+
29,9,85,51,174,+
16,54,58,84,212,+
92,46,57,12,207,+
52,24,12,93,181,+
90,73,26,85,274,+
50,80,66,78,274,+
18,26,48,14,106,+
83,3,96,13,195,+
81,51,21,17,170,+
61,93,94,65,313,+
59,29,41,6,135,+
76,65,52,45,238,+
54,13,74,10,151,+
54,38,10,69,171,+
58,48,28,86,220,+
59,89,35,77,260,+
49,3,54,91,197,+
94,29,26,55,204,+
14,29,80,27,150,+
71,83,17,8,179,+
89,42,55,95,281,+
23,9,45,50,127,+
98,96,50,8,252,+
19,38,25,16,98,+
9,20,0,93,122,+
49,15,35,11,110,+
62,32,1,7,102,+
80,23,17,99,219,+
91,4,20,84,199,+
38,18,24,81,161,+
61,84,94,69,308,+
78,59,5,86,228,+
40,35,7,77,159,+
92,10,60,98,260,+
80,63,11,97,251,+
77,16,71,75,239,+
72,90,32,9,203,+
20,80,77,91,268,+
85,88,59,11,243,+
79,93,61,38,271,+
5,46,17,15,83,+
62,13,14,51,140,+
42,45,35,32,154,+
79,9,21,31,140,+
62,90,25,22,199,+
35,81,66,35,217,+
90,5,80,51,226,+
23,71,92,16,202,+
3,88,15,39,145,+
86,84,31,29,230,+
23,52,0,67,142,+
4,47,50,34,135,+
95,5,74,95,269,+
94,55,96,56,301,+
47,53,53,71,224,+
81,13,1,95,190,+
70,77,4,40,191,+
47,59,56,68,230,+
39,78,52,97,266,+
54,70,69,58,251,+
68,53,65,71,257,+
41,39,61,40,181,+
9,73,89,68,239,+
74,7,19,43,143,+
74,15,48,71,208,+
14,33,80,15,142,+
24,66,99,29,218,+
75,81,99,20,275,+
97,60,41,64,262,+
33,5,23,23,84,+
27,66,9,4,106,+
96,82,63,75,316,+
97,68,84,81,330,+
98,48,51,4,201,+
1,97,17,33,148,+
8,52,90,13,163,+
61,43,99,97,300,+
62,33,66,84,245,+
6,66,70,79,221,+
16,41,34,22,113,+
6,53,4,38,101,+
65,65,5,37,172,+
85,35,86,73,279,+
44,6,49,17,116,+
93,81,21,17,212,+
94,81,61,4,240,+
27,95,72,61,255,+
56,57,75,87,275,+
70,0,78,31,179,+
50,46,2,3,101,+
4,89,40,79,212,+
82,59,18,8,167,+
10,23,29,22,84,+
21,54,91,1,167,+
80,59,70,76,285,+
76,72,11,47,206,+
85,21,39,74,219,+
39,51,46,92,228,+
93,34,36,62,225,+
92,50,38,59,239,+
73,26,95,7,201,+
60,5,16,61,142,+
2,48,33,73,156,+
42,53,71,62,228,+
97,90,6,90,283,+
95,90,13,91,289,+
51,27,97,62,237,+
2,77,95,5,179,+
63,51,51,54,219,+
79,56,51,5,191,+
34,53,32,59,178,+
8,29,83,38,158,+
1,69,95,42,207,+
83,88,23,14,208,+
21,85,42,45,193,+
18,33,28,15,94,+
85,70,33,72,260,+
17,13,42,38,110,+
7,92,67,0,166,+
99,2,1,99,201,+
61,18,30,84,193,+
99,85,50,70,304,+
82,53,25,83,243,+
74,68,27,60,229,+
60,50,9,54,173,+
34,31,45,13,123,+
87,31,92,99,309,+
18,30,45,93,186,+
98,87,39,18,242,+
95,61,79,78,313,+
21,85,88,50,244,+
82,65,92,79,318,+
5,98,93,69,265,+
62,12,50,18,142,+
20,83,12,42,157,+
20,3,27,91,141,+
91,85,55,22,253,+
54,25,41,31,151,+
16,23,70,56,165,+
67,2,41,92,202,+
91,63,33,64,251,+
20,81,42,46,189,+
43,92,47,29,211,+
33,5,83,37,158,+
30,83,14,91,218,+
82,62,43,42,229,+
28,38,57,50,173,+
24,23,91,5,143,+
80,75,84,72,311,+
15,96,31,23,165,+
6,27,5,55,93,+
31,8,33,55,127,+
64,92,14,97,267,+
32,55,20,33,140,+
0,77,14,73,164,+
2,68,62,82,214,+
18,70,93,57,238,+
19,75,93,63,250,+
36,49,55,55,195,+
12,45,51,49,157,+
37,73,21,52,183,+
65,13,48,82,208,+
38,56,86,42,222,+
53,58,27,76,214,+
28,78,39,11,156,+
77,90,98,1,266,+
27,76,23,39,165,+
52,44,77,47,220,+
92,5,21,26,144,+
7,38,32,24,101,+
87,35,41,2,165,+
51,7,5,67,130,+
36,66,35,74,211,+
98,43,8,75,224,+
4,88,64,27,183,+
32,93,40,34,199,+
80,6,8,1,95,+
86,72,13,13,184,+
56,34,49,26,165,+
75,28,89,99,291,+
44,74,95,71,284,+
88,65,44,39,236,+
51,75,9,92,227,+
69,8,60,73,210,+
5,28,57,96,186,+
39,85,66,48,238,+
86,94,11,76,267,+
42,27,37,96,202,+
27,97,68,58,250,+
40,14,66,57,177,+
80,81,87,22,270,+
82,90,42,75,289,+
59,18,69,85,231,+
33,34,95,18,180,+
77,30,79,44,230,+
25,56,64,28,173,+
66,92,49,27,234,+
96,69,94,22,281,+
1,11,26,83,121,+
38,5,51,17,111,+
23,33,8,65,129,+
30,87,71,49,237,+
78,21,47,44,190,+
69,63,25,23,180,+
40,38,52,27,157,+
1,0,46,35,82,+
49,61,16,13,139,+
46,79,59,36,220,+
33,7,63,42,145,+
11,70,58,50,189,+
25,71,98,94,288,+
17,36,84,34,171,+
55,44,5,75,179,+
9,22,63,56,150,+
58,58,89,1,206,+
99,18,61,46,224,+
91,13,5,91,200,+
20,79,71,97,267,+
94,70,99,23,286,+
30,53,25,93,201,+
20,98,24,34,176,+
77,13,89,19,198,+
70,98,16,93,277,+
0,26,38,27,91,+
83,4,73,7,167,+
49,43,70,10,172,+
81,67,65,3,216,+
17,59,66,43,185,+
5,71,18,86,180,+
74,45,93,72,284,+
58,19,26,44,147,+
6,2,62,59,129,+
19,16,32,41,108,+
56,16,1,53,126,+
78,21,22,30,151,+
99,8,33,14,154,+
93,5,96,31,225,+
70,60,77,30,237,+
88,29,22,21,160,+
58,84,70,68,280,+
48,92,9,21,170,+
41,39,17,93,190,+
5,51,72,62,190,+
31,1,86,95,213,+
38,54,31,10,133,+
34,28,67,48,177,+
4,64,88,33,189,+
63,28,10,8,109,+
26,88,94,33,241,+
93,89,29,78,289,+
30,26,28,22,106,+
76,64,49,51,240,+
44,67,26,14,151,+
17,5,35,16,73,+
27,28,17,3,75,+
94,88,53,20,255,+
51,8,4,84,147,+
77,90,82,29,278,+
29,46,66,28,169,+
73,59,86,64,282,+
85,32,30,10,157,+
83,25,50,96,254,+
40,82,12,19,153,+
18,20,5,71,114,+
68,29,25,33,155,+
45,74,98,42,259,+
57,82,15,10,164,+
78,49,78,22,227,+
55,73,92,23,243,+
15,6,33,31,85,+
93,91,56,33,273,+
39,93,32,31,195,+
58,38,8,78,182,+
17,46,30,57,150,+
30,23,9,54,116,+
22,54,20,59,155,+
36,48,2,32,118,+
15,17,36,72,140,+
52,80,56,45,233,+
45,88,24,86,243,+
37,33,75,91,236,+
68,15,64,57,204,+
13,39,89,39,180,+
48,83,25,43,199,+
80,52,34,18,184,+
83,87,91,9,270,+
87,61,71,93,312,+
58,92,61,28,239,+
33,21,88,83,225,+
12,99,76,8,195,+
21,4,47,21,93,+
7,86,41,70,204,+
84,15,9,7,115,+
8,92,5,44,149,+
65,47,43,45,200,+
93,58,8,41,200,+
2,97,1,69,169,+
4,53,93,77,227,+
17,8,42,40,107,+
67,49,4,78,198,+
96,90,6,0,192,+
72,91,86,58,307,+
44,81,91,67,283,+
12,31,1,91,135,+
5,35,7,33,80,+
29,31,96,53,209,+
44,64,45,76,229,+
94,30,56,20,200,+
97,40,36,34,207,+
65,70,78,92,305,+
58,61,13,83,215,+
50,36,71,12,169,+
5,57,79,55,196,+
13,57,45,76,191,+
39,54,38,31,162,+
21,2,41,96,160,+
84,28,71,21,204,+
11,14,12,86,123,+
64,44,62,56,226,+
55,67,20,53,195,+
60,77,20,44,201,+
31,77,59,88,255,+
18,24,62,78,182,+
97,4,94,62,257,+
26,2,29,14,71,+
95,70,96,89,350,+
3,91,0,14,108,+
88,61,14,83,246,+
13,69,25,45,152,+
77,75,95,2,249,+
49,66,21,69,205,+
10,74,66,59,209,+
94,88,19,2,203,+
84,85,86,13,268,+
41,48,79,46,214,+
31,70,89,75,265,+
32,16,28,82,158,+
55,95,80,38,268,+
80,10,41,42,173,+
12,1,90,30,133,+
89,69,81,7,246,+
9,63,56,58,186,+
98,98,16,53,265,+
62,68,72,78,280,+
56,82,97,4,239,+
82,45,45,91,263,+
78,58,11,95,242,+
72,2,20,1,95,+
24,67,82,25,198,+
10,34,70,10,124,+
79,87,7,91,264,+
38,73,0,42,153,+
53,86,6,69,214,+
88,56,83,89,316,+
6,4,68,12,90,+
62,10,37,60,169,+
33,21,84,30,168,+
27,28,6,59,120,+
0,91,94,13,198,+
52,66,78,37,233,+
20,16,99,3,138,+
54,36,82,4,176,+
65,12,87,76,240,+
9,22,99,23,153,+
70,70,37,35,212,+
81,95,29,47,252,+
13,54,57,0,124,+
91,59,76,19,245,+
37,47,65,72,221,+
56,36,65,34,191,+
87,38,73,55,253,+
73,85,3,57,218,+
74,11,67,66,218,+
93,47,11,52,203,+
3,7,36,68,114,+
7,56,82,40,185,+
26,31,69,19,145,+
41,21,39,49,150,+
99,89,55,11,254,+
79,22,74,96,271,+
94,56,91,11,252,+
97,24,70,79,270,+
84,16,81,66,247,+
83,64,59,69,275,+
8,93,57,5,163,+
36,9,7,81,133,+
27,65,5,95,192,+
94,33,23,89,239,+
49,47,66,37,199,+
53,47,53,45,198,+
45,54,20,44,163,+
27,67,34,76,204,+
96,83,52,42,273,+
48,65,73,6,192,+
40,82,97,66,285,+
41,0,88,66,195,+
73,94,82,55,304,+
62,28,58,7,155,+
64,10,17,92,183,+
73,62,58,77,270,+
41,44,97,64,246,+
47,94,78,62,281,+
58,72,58,83,271,+
35,83,45,37,200,+
40,97,70,70,277,+
29,65,19,1,114,+
5,85,0,10,100,+
29,50,9,59,147,+
87,67,10,19,183,+
6,36,71,73,186,+
36,40,63,37,176,+
15,23,36,56,130,+
96,11,54,13,174,+
8,11,16,89,124,+
50,33,92,21,196,+
96,34,45,5,180,+
35,57,36,77,205,+
72,43,53,71,239,+
14,61,63,53,191,+
9,46,9,63,127,+
38,84,74,65,261,+
53,37,24,25,139,+
95,96,19,40,250,+
4,3,67,11,85,+
45,63,57,45,210,+
4,51,44,51,150,+
30,49,52,92,223,+
81,29,57,58,225,+
90,75,4,72,241,+
71,30,91,21,213,+
18,23,28,79,148,+
8,48,49,38,143,+
29,99,0,52,180,+
36,6,0,1,43,+
50,19,80,74,223,+
52,81,79,93,305,+
71,33,46,58,208,+
76,76,92,74,318,+
36,64,98,58,256,+
42,72,83,61,258,+
47,0,87,27,161,+
63,40,47,77,227,+
6,18,5,39,68,+
0,28,54,55,137,+
13,12,30,24,79,+
90,55,67,90,302,+
44,59,35,55,193,+
12,78,5,98,193,+
66,31,33,34,164,+
18,27,17,57,119,+
18,50,49,63,180,+
29,80,50,4,163,+
34,11,29,43,117,+
64,81,26,36,207,+
94,73,43,87,297,+
0,31,70,69,170,+
8,33,21,79,141,+
93,81,84,39,297,+
93,10,3,5,111,+
78,60,51,27,216,+
68,4,92,71,235,+
2,70,20,9,101,+
20,23,91,16,150,+
58,90,96,33,277,+
89,90,97,87,363,+
41,21,79,1,142,+
71,79,20,89,259,+
63,9,21,91,184,+
69,97,80,80,326,+
40,15,56,51,162,+
92,83,21,85,281,+
50,25,3,91,169,+
69,71,96,69,305,+
91,74,33,60,258,+
44,16,34,86,180,+
86,90,74,77,327,+
28,56,96,20,200,+
4,26,45,34,109,+
5,18,0,46,69,+
6,59,64,61,190,+
66,0,42,92,200,+
33,90,4,55,182,+
70,4,0,42,116,+
56,78,88,86,308,+
80,27,84,89,280,+
35,87,89,7,218,+
15,91,44,10,160,+
87,44,10,24,165,+
92,33,87,80,292,+
1,70,44,92,207,+
16,97,56,30,199,+
66,55,86,66,273,+
25,99,33,61,218,+
85,4,73,12,174,+
62,47,24,2,135,+
39,32,36,14,121,+
12,81,13,95,201,+
26,13,2,39,80,+
19,24,91,35,169,+
84,30,86,89,289,+
75,60,13,81,229,+
25,47,76,88,236,+
56,57,23,76,212,+
88,96,69,44,297,+
78,72,11,66,227,+
16,29,90,14,149,+
88,53,90,86,317,+
85,49,62,34,230,+
64,29,1,55,149,+
86,85,52,52,275,+
95,19,63,88,265,+
76,76,52,55,259,+
47,47,94,11,199,+
87,59,72,63,281,+
96,23,32,23,174,+
15,44,16,85,160,+
64,86,17,71,238,+
26,7,19,18,70,+
60,14,25,41,140,+
44,75,42,3,164,+
12,19,9,55,95,+
3,85,30,26,144,+
65,52,60,33,210,+
50,58,28,37,173,+
57,82,55,37,231,+
19,42,93,74,228,+
54,15,36,74,179,+
39,16,65,10,130,+
26,95,24,25,170,+
23,19,95,60,197,+
39,12,41,16,108,+
50,4,86,10,150,+
29,82,49,65,225,+
66,22,59,96,243,+
10,39,21,6,76,+
85,17,17,12,131,+
47,29,77,53,206,+
58,39,90,91,278,+
31,98,69,54,252,+
42,20,81,51,194,+
12,12,37,38,99,+
67,39,57,0,163,+
95,81,41,20,237,+
88,39,23,80,230,+
13,22,12,82,129,+
55,12,26,98,191,+
67,28,78,90,263,+
94,15,91,37,237,+
3,32,21,53,109,+
46,99,89,92,326,+
71,7,51,71,200,+
2,24,43,98,167,+
50,17,36,92,195,+
76,82,70,11,239,+
14,21,56,10,101,+
86,98,3,91,278,+
6,63,95,62,226,+
53,22,33,4,112,+
10,97,93,10,210,+
41,37,52,15,145,+
94,94,3,76,267,+
50,0,69,48,167,+
84,81,84,7,256,+
97,7,70,42,216,+
3,54,72,99,228,+
20,32,90,48,190,+
98,38,32,94,262,+
73,91,23,47,234,+
50,55,30,39,174,+
12,12,67,77,168,+
46,79,4,60,189,+
68,96,47,49,260,+
49,37,28,70,184,+
38,54,74,82,248,+
37,17,85,27,166,+
8,42,23,79,152,+
66,27,97,94,284,+
9,69,81,94,253,+
34,11,49,62,156,+
5,42,83,20,150,+
65,27,24,43,159,+
64,40,41,97,242,+
34,66,38,71,209,+
32,8,11,29,80,+
88,18,49,69,224,+
18,54,24,92,188,+
15,83,76,9,183,+
24,43,92,56,215,+
32,25,10,33,100,+
26,43,77,24,170,+
52,46,88,50,236,+
82,3,72,77,234,+
37,78,35,71,221,+
90,38,37,34,199,+
41,4,85,70,200,+
7,40,21,41,109,+
73,10,20,33,136,+
22,92,10,57,181,+
30,91,12,83,216,+
85,89,38,68,280,+
15,62,19,26,122,+
60,68,88,54,270,+
6,18,19,29,72,+
6,47,99,62,214,+
46,54,17,94,211,+
65,87,0,66,218,+
42,64,75,0,181,+
35,15,59,87,196,+
34,58,82,68,242,+
12,78,98,77,265,+
17,23,98,8,146,+
56,32,60,3,151,+
69,30,56,5,160,+
9,48,95,12,164,+
60,41,96,49,246,+
69,26,86,97,278,+
93,68,78,56,295,+
28,45,38,66,177,+
6,84,40,31,161,+
60,49,91,70,270,+
90,88,30,47,255,+
56,84,95,86,321,+
94,18,71,70,253,+
47,15,93,94,249,+
8,6,59,22,95,+
91,66,9,62,228,+
10,6,10,65,91,+
31,63,4,97,195,+
26,85,55,4,170,+
6,87,10,95,198,+
54,86,13,11,164,+
21,55,68,5,149,+
45,35,89,97,266,+
79,37,25,97,238,+
98,83,6,82,269,+
10,41,19,9,79,+
86,15,51,69,221,+
17,32,59,83,191,+
66,70,45,73,254,+
69,84,10,22,185,+
15,90,10,43,158,+
66,30,54,82,232,+
36,73,14,0,123,+
41,57,73,20,191,+
32,82,26,95,235,+
69,99,43,91,302,+
10,21,10,29,70,+
12,42,58,4,116,+
77,59,93,61,290,+
48,68,10,30,156,+
68,29,3,96,196,+
80,36,16,10,142,+
82,21,88,64,255,+
51,91,23,88,253,+
50,20,86,51,207,+
37,87,77,71,272,+
17,17,28,75,137,+
34,57,36,25,152,+
73,84,28,89,274,+
2,65,45,65,177,+
42,23,7,13,85,+
20,67,62,87,236,+
45,82,35,35,197,+
96,72,42,3,213,+
19,78,91,63,251,+
31,35,48,31,145,+
14,55,82,0,151,+
90,74,63,90,317,+
21,97,0,38,156,+
2,62,68,68,200,+
72,85,65,82,304,+
66,62,29,1,158,+
39,76,0,59,174,+
58,34,21,31,144,+
90,16,9,27,142,+
87,88,46,15,236,+
49,77,91,33,250,+
12,35,0,29,76,+
30,44,68,21,163,+
13,61,64,19,157,+
34,18,50,44,146,+
88,50,47,23,208,+
23,22,95,26,166,+
88,0,31,31,150,+
81,63,72,55,271,+
29,94,98,23,244,+
98,0,36,95,229,+
12,85,9,28,134,+
47,4,75,44,170,+
26,43,31,9,109,+
98,78,64,68,308,+
67,42,67,94,270,+
20,11,0,22,53,+
65,89,92,34,280,+
27,81,94,55,257,+
14,92,32,77,215,+
59,3,87,30,179,+
71,1,72,88,232,+
95,63,41,60,259,+
53,34,66,96,249,+
46,47,13,79,185,+
8,24,47,70,149,+
64,11,47,13,135,+
32,68,26,4,130,+
82,14,33,73,202,+
29,20,15,30,94,+
3,20,20,51,94,+
67,33,42,87,229,+
55,21,29,82,187,+
16,75,50,60,201,+
18,49,85,38,190,+
59,60,55,84,258,+
99,53,97,76,325,+
14,80,0,68,162,+
73,28,93,56,250,+
60,54,38,57,209,+
18,62,32,89,201,+
88,99,63,36,286,+
6,6,29,78,119,+
51,99,74,0,224,+
96,38,89,90,313,+
99,18,62,61,240,+
93,43,83,98,317,+
58,89,76,93,316,+
13,12,90,89,204,+
18,98,38,98,252,+
45,75,75,82,277,+
88,39,36,57,220,+
50,88,10,34,182,+
48,15,6,50,119,+
19,4,82,32,137,+
51,96,64,39,250,+
55,93,77,53,278,+
53,20,79,64,216,+
43,84,96,88,311,+
82,35,0,67,184,+
36,7,92,75,210,+
79,16,39,88,222,+
41,19,30,3,93,+
84,43,42,83,252,+
54,0,69,78,201,+
77,63,6,6,152,+
34,26,61,82,203,+
2,66,88,89,245,+
61,6,84,19,170,+
34,46,38,49,167,+
59,43,86,62,250,+
20,68,81,75,244,+
2,49,92,26,169,+
77,78,65,38,258,+
75,71,56,74,276,+
30,70,35,27,162,+
7,47,75,66,195,+
42,90,51,18,201,+
52,39,89,39,219,+
6,3,77,13,99,+
39,83,93,32,247,+
99,90,64,16,269,+
37,45,20,98,200,+
20,52,77,74,223,+
28,85,38,0,151,+
43,36,93,49,221,+
25,46,26,88,185,+
29,43,89,56,217,+
8,29,52,54,143,+
46,15,68,40,169,+
46,94,75,53,268,+
62,51,41,9,163,+
19,26,77,30,152,+
36,84,25,43,188,+
55,10,88,23,176,+
94,58,85,73,310,+
49,80,66,27,222,+
57,67,21,43,188,+
14,40,47,0,101,+
89,71,19,58,237,+
54,46,71,72,243,+
35,3,96,3,137,+
78,69,94,75,316,+
32,65,49,73,219,+
40,53,15,25,133,+
62,8,43,82,195,+
97,52,3,65,217,+
99,98,24,5,226,+
40,43,88,34,205,+
67,76,71,38,252,+
89,43,99,77,308,+
56,49,88,52,245,+
71,41,48,10,170,+
17,40,36,27,120,+
57,25,12,80,174,+
16,52,39,57,164,+
33,91,84,6,214,+
1,32,63,36,132,+
26,67,27,29,149,+
56,1,7,8,72,+
28,59,11,94,192,+
18,80,52,70,220,+
70,42,93,54,259,+
54,12,41,14,121,+
63,99,26,94,282,+
37,95,98,98,328,+
86,97,60,40,283,+
61,95,68,68,292,+
98,2,53,56,209,+
78,58,57,0,193,+
46,32,94,23,195,+
14,19,44,65,142,+
17,41,62,5,125,+
47,41,59,34,181,+
13,71,57,53,194,+
28,27,89,67,211,+
86,86,57,29,258,+
81,37,96,6,220,+
17,36,89,0,142,+
9,29,13,7,58,+
19,72,74,22,187,+
6,66,17,4,93,+
49,39,88,32,208,+
92,6,54,33,185,+
41,72,41,71,225,+
46,70,40,76,232,+
51,97,93,15,256,+
86,70,29,36,221,+
68,9,42,21,140,+
34,1,26,36,97,+
74,83,13,66,236,+
80,76,58,6,220,+
70,30,24,77,201,+
79,44,11,80,214,+
24,8,33,19,84,+
87,22,87,28,224,+
58,22,21,43,144,+
42,21,48,74,185,+
63,30,28,11,132,+
14,64,41,38,157,+
61,98,42,34,235,+
24,38,78,83,223,+
48,8,86,58,200,+
0,97,64,23,184,+
51,68,48,23,190,+
99,44,47,99,289,+
28,10,23,51,112,+
26,90,32,35,183,+
59,20,17,8,104,+
83,44,19,52,198,+
50,62,31,4,147,+
4,56,36,65,161,+
90,7,47,26,170,+
83,60,87,54,284,+
39,29,45,58,171,+
7,61,80,14,162,+
56,91,27,7,181,+
61,61,21,50,193,+
98,85,11,48,242,+
94,9,12,92,207,+
48,0,45,94,187,+
96,31,2,62,191,+
71,75,60,81,287,+
44,96,56,53,249,+
74,65,54,98,291,+
36,16,39,6,97,+
61,11,74,68,214,+
45,68,4,50,167,+
72,94,18,69,253,+
20,21,45,1,87,+
32,53,16,81,182,+
58,8,71,57,194,+
38,14,7,37,96,+
49,75,84,45,253,+
22,9,21,60,112,+
88,55,29,24,196,+
31,7,96,30,164,+
31,8,31,56,126,+
80,52,96,24,252,+
17,93,55,28,193,+
6,4,73,92,175,+
18,9,98,20,145,+
67,47,99,32,245,+
19,92,4,73,188,+
42,41,18,33,134,+
74,53,54,63,244,+
83,36,4,47,170,+
34,27,2,35,98,+
59,62,91,27,239,+
62,6,44,59,171,+
99,32,7,42,180,+
30,33,36,32,131,+
12,77,8,7,104,+
37,16,69,5,127,+
22,90,73,66,251,+
88,22,63,58,231,+
96,27,94,46,263,+
56,60,57,90,263,+
89,39,21,47,196,+
30,37,82,88,237,+
18,50,5,93,166,+
6,75,14,7,102,+
96,4,34,59,193,+
82,57,97,1,237,+
70,43,59,1,173,+
96,78,57,65,296,+
44,8,22,20,94,+
39,10,76,27,152,+
33,26,73,6,138,+
51,78,19,90,238,+
30,44,64,69,207,+
89,73,44,66,272,+
16,11,35,78,140,+
41,71,93,77,282,+
71,92,66,14,243,+
60,52,88,32,232,+
44,18,55,13,130,+
82,85,80,10,257,+
93,96,14,21,224,+
15,68,66,28,177,+
52,19,21,83,175,+
7,53,58,80,198,+
46,97,92,69,304,+
32,34,85,12,163,+
73,3,38,5,119,+
9,39,56,34,138,+
29,47,31,32,139,+
78,6,91,60,235,+
49,71,30,1,151,+
36,24,17,66,143,+
65,39,46,54,204,+
86,83,21,84,274,+
77,16,67,91,251,+
11,37,7,9,64,+
78,94,24,18,214,+
72,93,8,89,262,+
98,74,38,1,211,+
14,8,14,39,75,+
59,99,4,68,230,+
19,96,20,60,195,+
19,13,4,11,47,+
68,62,25,68,223,+
91,25,57,72,245,+
63,3,41,88,195,+
57,24,60,13,154,+
91,2,19,24,136,+
66,42,5,30,143,+
21,32,99,36,188,+
8,93,36,55,192,+
81,48,78,48,255,+
47,20,50,16,133,+
47,43,44,49,183,+
92,98,42,32,264,+
17,94,37,72,220,+
35,89,57,69,250,+
20,52,49,35,156,+
83,81,27,68,259,+
31,30,2,73,136,+
21,74,71,10,176,+
86,70,19,20,195,+
57,87,12,95,251,+
87,33,87,0,207,+
14,72,38,52,176,+
18,94,47,21,180,+
28,35,53,46,162,+
48,93,91,36,268,+
60,7,3,18,88,+
6,62,93,85,246,+
58,7,8,53,126,+
69,85,41,36,231,+
31,21,66,70,188,+
79,59,54,16,208,+
43,61,21,78,203,+
9,52,8,17,86,+
17,84,77,78,256,+
33,94,72,93,292,+
84,51,76,62,273,+
26,74,74,46,220,+
75,2,87,20,184,+
49,93,4,16,162,+
45,48,17,92,202,+
13,11,58,14,96,+
83,69,41,96,289,+
65,72,42,88,267,+
6,68,45,64,183,+
9,88,70,96,263,+
12,22,7,45,86,+
87,79,36,77,279,+
90,74,2,4,170,+
23,99,66,75,263,+
93,63,80,57,293,+
36,93,37,97,263,+
4,8,69,10,91,+
77,24,15,64,180,+
70,64,46,0,180,+
72,97,47,22,238,+
94,44,21,26,185,+
37,19,33,43,132,+
2,91,69,15,177,+
15,50,97,86,248,+
93,53,94,42,282,+
27,15,32,45,119,+
50,66,20,46,182,+
31,39,54,18,142,+
43,44,16,37,140,+
10,75,21,47,153,+
36,18,45,31,130,+
92,18,51,88,249,+
44,75,52,32,203,+
71,93,72,59,295,+
77,12,38,32,159,+
21,52,27,43,143,+
2,18,49,33,102,+
76,14,22,64,176,+
29,3,19,53,104,+
40,42,94,84,260,+
22,80,75,76,253,+
53,56,66,3,178,+
28,54,77,61,220,+
41,59,77,80,257,+
6,19,69,5,99,+
67,19,41,7,134,+
90,86,91,5,272,+
13,30,3,44,90,+
39,79,42,57,217,+
39,92,48,70,249,+
0,26,63,96,185,+
59,25,34,71,189,+
19,13,67,6,105,+
4,58,0,50,112,+
37,41,92,32,202,+
85,74,50,76,285,+
48,3,38,41,130,+
14,51,33,38,136,+
14,70,82,16,182,+
50,0,54,19,123,+
27,68,5,47,147,+
31,44,9,27,111,+
86,85,45,87,303,+
89,4,45,30,168,+
2,24,29,84,139,+
22,31,9,1,63,+
65,45,71,98,279,+
36,97,51,34,218,+
20,42,24,28,114,+
0,80,56,93,229,+
2,43,56,48,149,+
44,96,48,9,197,+
19,25,9,44,97,+
3,53,18,55,129,+
15,90,91,67,263,+
4,51,51,10,116,+
58,30,11,90,189,+
47,50,18,85,200,+
19,85,16,83,203,+
63,69,66,82,280,+
2,45,8,0,55,+
82,64,28,68,242,+
94,67,81,99,341,+
77,21,39,44,181,+
24,46,8,10,88,+
83,6,71,81,241,+
94,26,80,81,281,+
65,51,16,50,182,+
79,39,58,12,188,+
73,86,18,33,210,+
99,67,48,17,231,+
25,49,45,93,212,+
20,56,35,22,133,+
36,27,84,37,184,+
40,4,46,77,167,+
36,22,85,71,214,+
31,15,58,12,116,+
45,28,84,74,231,+
31,66,16,79,192,+
91,33,56,56,236,+
42,32,37,24,135,+
1,11,12,37,61,+
41,90,9,2,142,+
33,22,80,66,201,+
87,66,6,27,186,+
45,55,74,63,237,+
47,81,45,4,177,+
28,54,86,70,238,+
59,80,51,54,244,+
72,0,90,53,215,+
47,61,47,78,233,+
26,60,61,95,242,+
15,74,7,72,168,+
30,51,19,92,192,+
81,16,0,84,181,+
70,14,42,53,179,+
65,48,71,31,215,+
47,73,30,69,219,+
74,28,70,56,228,+
84,94,46,52,276,+
57,8,45,41,151,+
32,44,19,58,153,+
78,63,40,1,182,+
8,93,22,82,205,+
42,64,92,55,253,+
83,20,25,6,134,+
41,77,0,44,162,+
43,77,12,85,217,+
57,67,28,93,245,+
31,65,82,28,206,+
69,88,74,76,307,+
33,48,45,89,215,+
35,32,47,39,153,+
69,15,53,51,188,+
77,64,71,8,220,+
5,86,5,53,149,+
99,25,92,3,219,+
76,98,11,9,194,+
35,11,9,93,148,+
14,17,33,84,148,+
28,10,89,59,186,+
81,85,36,71,273,+
64,60,59,34,217,+
88,90,99,28,305,+
43,83,73,5,204,+
32,23,21,54,130,+
75,1,45,99,220,+
12,97,23,48,180,+
48,91,41,8,188,+
52,17,82,69,220,+
93,68,92,93,346,+
73,46,4,48,171,+
56,37,57,79,229,+
48,4,21,23,96,+
95,23,75,72,265,+
45,86,91,88,310,+
1,71,14,43,129,+
50,9,54,78,191,+
48,11,81,4,144,+
13,33,22,84,152,+
38,39,42,80,199,+
29,47,50,86,212,+
77,4,79,82,242,+
63,4,12,63,142,+
99,53,10,67,229,+
57,8,28,21,114,+
45,44,25,37,151,+
71,74,35,9,189,+
47,96,9,26,178,+
16,16,59,24,115,+
6,96,88,75,265,+
10,56,48,49,163,+
62,15,46,21,144,+
63,63,13,3,142,+
6,78,15,9,108,+
56,98,26,9,189,+
55,57,66,21,199,+
18,18,56,15,107,+
85,1,25,15,126,+
65,15,53,1,134,+
41,66,31,89,227,+
98,7,43,41,189,+
30,91,9,5,135,+
38,26,67,31,162,+
47,29,3,37,116,+
92,21,43,19,175,+
37,86,2,34,159,+
65,25,53,33,176,+
81,59,2,71,213,+
83,10,33,11,137,+
55,79,82,73,289,+
99,88,20,94,301,+
5,24,34,65,128,+
83,87,31,39,240,+
66,78,67,12,223,+
35,21,54,89,199,+
91,13,96,67,267,+
25,59,81,32,197,+
36,19,60,71,186,+
12,6,22,76,116,+
31,52,4,76,163,+
6,7,8,80,101,+
26,10,61,10,107,+
96,83,98,30,307,+
7,87,16,11,121,+
23,14,39,18,94,+
60,48,90,78,276,+
81,74,85,99,339,+
11,67,51,56,185,+
26,8,78,90,202,+
8,36,56,72,172,+
85,33,99,58,275,+
27,56,59,79,221,+
17,57,65,48,187,+
92,7,45,49,193,+
40,5,96,42,183,+
40,44,96,28,208,+
71,76,11,26,184,+
39,9,1,37,86,+
77,21,31,10,139,+
74,93,59,42,268,+
49,45,84,40,218,+
85,4,49,44,182,+
9,73,21,38,141,+
85,26,98,53,262,+
1,58,7,28,94,+
67,41,6,16,130,+
71,8,20,78,177,+
1,26,77,8,112,+
79,71,30,76,256,+
38,78,94,51,261,+
41,90,90,19,240,+
45,38,42,74,199,+
64,92,55,28,239,+
86,26,60,92,264,+
87,21,93,71,272,+
34,70,91,89,284,+
56,75,56,26,213,+
43,29,20,87,179,+
16,22,1,72,111,+
14,71,0,80,165,+
52,83,96,36,267,+
42,7,37,57,143,+
82,11,73,47,213,+
79,19,2,32,132,+
73,10,8,45,136,+
50,83,12,16,161,+
88,50,48,60,246,+
56,0,37,1,94,+
67,42,0,13,122,+
70,80,40,77,267,+
75,18,62,69,224,+
56,70,65,71,262,+
73,33,38,78,222,+
3,19,23,76,121,+
70,22,10,98,200,+
19,53,53,79,204,+
1,17,46,58,122,+
16,89,17,34,156,+
28,87,58,66,239,+
42,42,80,47,211,+
93,20,10,75,198,+
67,96,17,69,249,+
72,6,77,36,191,+
68,25,13,73,179,+
62,50,12,81,205,+
82,5,57,38,182,+
94,73,6,13,186,+
8,27,94,82,211,+
92,99,35,12,238,+
15,11,46,43,115,+
72,32,64,11,179,+
3,4,70,45,122,+
47,47,57,33,184,+
73,73,22,17,185,+
12,57,41,40,150,+
31,76,67,84,258,+
30,17,44,26,117,+
17,24,18,21,80,+
91,33,21,16,161,+
38,45,20,66,169,+
1,92,17,77,187,+
95,49,86,66,296,+
33,48,26,46,153,+
48,3,53,3,107,+
50,89,99,90,328,+
90,46,19,35,190,+
33,96,29,51,209,+
16,98,39,12,165,+
38,70,67,53,228,+
67,27,22,2,118,+
25,45,76,81,227,+
3,40,44,46,133,+
11,23,56,6,96,+
28,55,32,33,148,+
90,16,50,53,209,+
56,27,33,59,175,+
3,9,27,68,107,+
2,24,70,16,112,+
75,99,94,20,288,+
68,74,90,23,255,+
3,61,86,57,207,+
9,38,40,24,111,+
48,30,83,13,174,+
78,74,29,29,210,+
7,64,61,60,192,+
44,19,23,49,135,+
68,65,8,34,175,+
95,69,52,85,301,+
11,88,39,96,234,+
10,2,32,0,44,+
5,39,36,92,172,+
92,17,84,79,272,+
13,42,1,87,143,+
84,17,63,77,241,+
46,31,79,92,248,+
72,28,4,13,117,+
17,79,83,48,227,+
4,21,78,13,116,+
28,72,49,93,242,+
48,53,71,10,182,+
33,67,97,63,260,+
62,11,69,2,144,+
2,68,67,94,231,+
25,12,44,12,93,+
76,40,56,88,260,+
66,31,77,30,204,+
43,6,1,78,128,+
45,42,75,91,253,+
76,69,32,32,209,+
29,76,31,64,200,+
2,14,56,1,73,+
7,77,86,12,182,+
80,10,68,66,224,+
88,62,74,20,244,+
9,97,51,15,172,+
25,15,26,35,101,+
88,17,64,25,194,+
16,28,15,67,126,+
35,67,29,69,200,+
15,96,13,56,180,+
78,92,22,95,287,+
9,68,57,33,167,+
64,61,73,47,245,+
32,97,39,36,204,+
12,82,76,52,222,+
71,45,25,35,176,+
26,33,32,16,107,+
58,10,11,63,142,+
30,18,33,95,176,+
0,6,94,9,109,+
24,97,68,84,273,+
63,97,50,86,296,+
49,8,60,74,191,+
97,22,3,40,162,+
24,16,42,38,120,+
28,81,13,97,219,+
0,56,63,4,123,+
84,25,12,71,192,+
17,52,57,73,199,+
98,11,98,91,298,+
48,94,18,87,247,+
69,90,24,74,257,+
37,6,24,0,67,+
11,12,85,83,191,+
92,33,95,99,319,+
12,58,11,27,108,+
87,9,75,63,234,+
38,9,39,65,151,+
70,41,20,43,174,+
30,36,19,24,109,+
45,87,56,49,237,+
24,84,78,70,256,+
89,15,95,99,298,+
97,66,75,32,270,+
87,57,98,2,244,+
60,9,49,80,198,+
60,35,39,6,140,+
75,92,92,73,332,+
78,97,4,60,239,+
4,74,17,4,99,+
9,47,45,20,121,+
64,32,53,43,192,+
2,59,27,87,175,+
21,58,23,21,123,+
59,82,65,86,292,+
80,79,69,42,270,+
50,33,83,53,219,+
14,78,53,30,175,+
91,48,63,75,277,+
22,98,11,60,191,+
14,43,20,95,172,+
35,30,28,4,97,+
44,21,60,23,148,+
78,36,44,75,233,+
27,81,24,55,187,+
40,80,49,48,217,+
32,34,85,75,226,+
60,7,7,50,124,+
72,95,59,33,259,+
4,97,23,3,127,+
36,10,13,33,92,+
89,15,90,16,210,+
82,74,8,95,259,+
59,85,95,52,291,+
36,85,95,7,223,+
90,48,86,30,254,+
4,78,44,17,143,+
41,20,70,74,205,+
40,60,56,21,177,+
18,66,87,44,215,+
64,79,53,0,196,+
28,26,8,79,141,+
19,30,39,22,110,+
31,81,36,74,222,+
27,23,92,21,163,+
71,61,64,9,205,+
79,22,51,72,224,+
83,59,25,88,255,+
61,25,44,7,137,+
43,50,94,38,225,+
0,46,58,53,157,+
55,19,12,76,162,+
19,68,53,88,228,+
59,33,91,63,246,+
1,97,28,54,180,+
20,78,75,37,210,+
23,59,80,39,201,+
62,30,3,48,143,+
42,73,76,62,253,+
94,46,50,99,289,+
63,1,28,28,120,+
81,67,50,75,273,+
29,92,82,2,205,+
30,7,33,2,72,+
20,88,86,23,217,+
55,23,95,89,262,+
74,88,85,0,247,+
95,44,0,30,169,+
69,63,28,29,189,+
32,53,44,42,171,+
40,92,93,40,265,+
83,44,70,36,233,+
53,93,90,59,295,+
85,69,42,66,262,+
73,88,72,77,310,+
60,55,66,73,254,+
38,37,43,68,186,+
29,57,4,2,92,+
90,51,74,42,257,+
82,75,93,83,333,+
96,74,39,43,252,+
33,87,96,91,307,+
48,93,29,1,171,+
32,26,97,99,254,+
62,93,98,59,312,+
67,2,32,60,161,+
3,72,0,36,111,+
89,55,43,56,243,+
83,38,61,31,213,+
91,53,11,35,190,+
72,90,23,21,206,+
89,87,51,97,324,+
72,67,2,95,236,+
21,15,72,77,185,+
52,14,33,10,109,+
76,11,29,49,165,+
1,75,31,73,180,+
95,91,56,20,262,+
61,87,9,29,186,+
76,26,38,34,174,+
29,4,66,69,168,+
31,88,76,89,284,+
69,3,44,67,183,+
98,26,34,78,236,+
35,10,95,4,144,+
20,6,85,96,207,+
33,90,44,98,265,+
89,89,89,21,288,+
25,30,60,75,190,+
40,12,62,78,192,+
3,87,59,62,211,+
47,67,40,92,246,+
95,87,21,49,252,+
89,92,29,78,288,+
64,75,99,19,257,+
67,46,2,7,122,+
81,81,57,93,312,+
3,4,40,68,115,+
62,61,43,22,188,+
45,76,77,40,238,+
11,85,68,28,192,+
70,78,10,57,215,+
68,10,6,97,181,+
4,91,43,66,204,+
28,55,59,30,172,+
28,30,51,40,149,+
82,42,78,94,296,+
56,4,47,85,192,+
9,33,93,22,157,+
80,46,32,40,198,+
24,2,37,16,79,+
10,58,51,89,208,+
2,41,31,18,92,+
19,13,7,87,126,+
56,62,4,45,167,+
15,10,96,25,146,+
23,6,94,95,218,+
25,47,18,22,112,+
28,9,30,84,151,+
67,52,2,13,134,+
5,11,96,57,169,+
91,99,92,44,326,+
48,64,98,95,305,+
73,90,21,95,279,+
4,83,10,12,109,+
97,82,25,38,242,+
81,64,90,66,301,+
80,32,67,91,270,+
54,63,15,27,159,+
32,21,99,90,242,+
51,93,74,77,295,+
98,44,99,87,328,+
26,67,65,52,210,+
99,37,34,26,196,+
48,12,15,21,96,+
57,22,98,72,249,+
61,63,99,46,269,+
91,56,37,83,267,+
74,91,60,86,311,+
78,25,74,52,229,+
47,91,32,69,239,+
79,51,69,22,221,+
90,37,47,56,230,+
25,50,91,30,196,+
28,73,67,17,185,+
43,35,97,61,236,+
80,7,89,23,199,+
86,92,21,79,278,+
54,60,1,79,194,+
19,73,49,14,155,+
22,94,29,34,179,+
2,17,63,1,83,+
28,29,87,81,225,+
77,32,56,88,253,+
69,6,7,15,97,+
24,53,68,34,179,+
13,11,86,85,195,+
46,53,92,29,220,+
17,57,81,85,240,+
50,48,33,37,168,+
69,1,34,20,124,+
51,91,36,80,258,+
18,70,18,24,130,+
19,86,70,72,247,+
34,81,68,22,205,+
33,8,9,27,77,+
32,11,58,64,165,+
45,74,50,49,218,+
46,59,41,47,193,+
3,30,92,61,186,+
91,61,6,94,252,+
72,88,55,74,289,+
74,69,45,66,254,+
8,89,57,67,221,+
84,54,48,72,258,+
23,87,90,67,267,+
45,81,82,89,297,+
56,96,47,48,247,+
41,2,79,39,161,+
66,20,57,62,205,+
24,75,10,36,145,+
50,98,94,3,245,+
41,25,57,41,164,+
22,29,61,0,112,+
20,73,37,76,206,+
99,3,43,50,195,+
21,67,19,81,188,+
59,64,13,52,188,+
5,21,92,92,210,+
34,11,20,1,66,+
21,42,3,86,152,+
5,41,29,49,124,+
49,41,41,64,195,+
32,57,26,2,117,+
40,98,85,11,234,+
9,25,4,70,108,+
8,46,55,32,141,+
36,90,51,41,218,+
94,21,85,0,200,+
96,81,75,84,336,+
18,42,2,86,148,+
82,90,64,2,238,+
48,8,79,2,137,+
73,22,1,57,153,+
79,4,40,22,145,+
8,52,51,2,113,+
3,75,0,11,89,+
74,18,86,26,204,+
43,3,35,9,90,+
84,20,55,29,188,+
76,8,84,27,195,+
33,24,62,95,214,+
23,12,38,6,79,+
11,46,29,58,144,+
16,33,54,8,111,+
87,65,99,69,320,+
90,15,94,85,284,+
20,39,4,81,144,+
27,56,50,88,221,+
85,83,69,23,260,+
17,92,16,98,223,+
50,87,55,92,284,+
32,14,48,13,107,+
94,32,20,37,183,+
97,45,99,55,296,+
88,17,56,44,205,+
52,70,65,60,247,+
15,76,69,50,210,+
87,11,85,9,192,+
16,4,65,25,110,+
40,17,38,77,172,+
19,91,14,45,169,+
91,91,99,21,302,+
9,26,70,60,165,+
34,87,56,63,240,+
33,2,49,78,162,+
16,49,34,99,198,+
16,63,4,88,171,+
47,0,99,67,213,+
92,20,33,81,226,+
89,37,65,35,226,+
91,30,85,76,282,+
84,72,61,77,294,+
20,8,44,38,110,+
97,37,75,4,213,+
30,18,18,44,110,+
56,55,2,22,135,+
65,98,12,77,252,+
1,38,14,43,96,+
24,92,92,55,263,+
68,90,97,94,349,+
11,67,10,45,133,+
74,63,7,18,162,+
84,12,42,2,140,+
16,45,35,78,174,+
43,62,97,82,284,+
40,29,73,99,241,+
89,77,91,72,329,+
9,90,51,61,211,+
96,11,32,13,152,+
2,14,34,22,72,+
46,23,87,74,230,+
4,28,8,49,89,+
61,15,2,61,139,+
21,60,46,25,152,+
86,95,63,44,288,+
42,19,96,35,192,+
48,93,80,75,296,+
82,62,95,79,318,+
90,41,39,70,240,+
25,17,40,6,88,+
30,14,5,94,143,+
20,6,63,42,131,+
3,26,95,15,139,+
78,63,98,1,240,+
11,75,54,59,199,+
47,87,36,38,208,+
25,35,74,85,219,+
43,93,83,79,298,+
81,78,56,36,251,+
81,0,86,87,254,+
15,63,6,76,160,+
36,53,19,2,110,+
53,16,56,89,214,+
58,61,64,79,262,+
97,36,43,62,238,+
22,13,72,13,120,+
68,5,78,52,203,+
59,66,79,51,255,+
81,74,84,19,258,+
71,8,28,81,188,+
39,12,15,67,133,+
99,34,22,72,227,+
75,30,32,59,196,+
18,0,54,20,92,+
5,99,10,22,136,+
17,39,80,84,220,+
51,83,17,11,162,+
35,9,20,59,123,+
56,85,45,53,239,+
85,63,33,20,201,+
95,86,57,48,286,+
41,76,63,92,272,+
18,90,67,22,197,+
98,32,9,28,167,+
16,12,75,76,179,+
67,14,96,82,259,+
79,62,38,77,256,+
26,65,93,33,217,+
2,91,47,43,183,+
64,19,86,9,178,+
88,59,58,62,267,+
64,25,61,50,200,+
72,60,1,11,144,+
35,23,58,13,129,+
40,48,33,97,218,+
58,90,40,82,270,+
86,61,44,55,246,+
8,64,18,86,176,+
75,81,9,73,238,+
15,87,92,12,206,+
23,26,1,43,93,+
89,30,53,40,212,+
67,65,35,63,230,+
3,97,60,40,200,+
37,26,91,6,160,+
41,90,93,28,252,+
71,35,8,68,182,+
62,86,19,62,229,+
45,71,86,44,246,+
96,5,42,21,164,+
78,94,42,69,283,+
19,0,55,50,124,+
24,10,26,11,71,+
77,32,66,83,258,+
19,62,55,59,195,+
26,69,81,35,211,+
11,21,58,65,155,+
14,51,71,23,159,+
49,80,35,91,255,+
21,17,26,18,82,+
47,8,21,85,161,+
34,60,72,74,240,+
65,7,32,1,105,+
87,50,95,66,298,+
81,51,89,65,286,+
83,7,78,75,243,+
19,22,40,87,168,+
94,53,57,77,281,+
13,43,12,51,119,+
59,78,54,57,248,+
44,25,52,55,176,+
73,31,3,55,162,+
32,28,0,28,88,+
60,85,39,3,187,+
26,62,46,32,166,+
53,43,32,78,206,+
89,98,40,40,267,+
26,74,7,63,170,+
67,74,33,12,186,+
37,96,91,35,259,+
30,75,42,31,178,+
49,56,35,27,167,+
88,16,87,71,262,+
81,21,19,88,209,+
42,10,72,12,136,+
46,84,20,30,180,+
98,77,69,55,299,+
34,26,91,63,214,+
0,14,66,14,94,+
44,10,28,87,169,+
79,93,1,32,205,+
65,39,79,95,278,+
52,80,38,24,194,+
87,88,8,96,279,+
12,24,32,51,119,+
42,87,33,60,222,+
2,62,1,58,123,+
19,34,89,46,188,+
91,36,17,98,242,+
86,8,69,1,164,+
2,59,3,91,155,+
42,42,79,7,170,+
15,80,31,17,143,+
50,11,19,68,148,+
75,29,36,6,146,+
67,84,26,69,246,+
69,62,62,54,247,+
68,64,74,82,288,+
42,35,95,18,190,+
15,17,12,6,50,+
56,75,34,13,178,+
94,80,73,80,327,+
81,37,77,67,262,+
22,35,80,72,209,+
10,98,11,97,216,+
35,63,17,39,154,+
56,73,56,94,279,+
5,64,21,84,174,+
55,53,14,5,127,+
81,73,75,89,318,+
69,64,66,14,213,+
36,25,8,41,110,+
29,54,81,71,235,+
64,75,31,0,170,+
4,80,7,61,152,+
9,60,61,40,170,+
83,27,67,30,207,+
59,21,85,90,255,+
63,47,90,35,235,+
30,90,54,98,272,+
64,86,35,97,282,+
85,34,26,89,234,+
67,92,77,34,270,+
24,64,83,78,249,+
70,45,23,30,168,+
49,43,68,48,208,+
95,22,97,69,283,+
54,26,99,14,193,+
21,16,8,47,92,+
53,17,24,84,178,+
24,48,85,47,204,+
24,95,69,1,189,+
85,47,59,35,226,+
91,89,25,46,251,+
77,39,94,21,231,+
81,54,45,20,200,+
41,27,65,61,194,+
10,85,91,90,276,+
74,77,17,60,228,+
65,65,95,90,315,+
69,25,27,70,191,+
66,39,77,24,206,+
80,27,92,70,269,+
77,79,32,95,283,+
38,57,15,17,127,+
62,72,17,16,167,+
96,25,3,53,177,+
72,58,36,15,181,+
18,69,74,32,193,+
5,61,85,16,167,+
42,16,71,80,209,+
12,75,30,19,136,+
56,94,39,80,269,+
25,92,9,90,216,+
79,5,89,48,221,+
94,52,83,4,233,+
39,24,84,63,210,+
6,88,10,4,108,+
0,70,55,42,167,+
6,1,20,15,42,+
28,65,85,33,211,+
86,11,38,97,232,+
85,79,23,63,250,+
41,78,52,11,182,+
93,77,58,17,245,+
91,46,42,58,237,+
58,14,95,51,218,+
41,96,13,28,178,+
76,75,3,23,177,+
32,35,4,31,102,+
12,83,25,18,138,+
78,0,18,67,163,+
0,0,20,46,66,+
20,18,50,36,124,+
70,63,95,35,263,+
90,75,60,0,225,+
47,4,22,92,165,+
32,89,58,61,240,+
41,32,73,99,245,+
99,98,23,93,313,+
62,92,15,77,246,+
8,56,48,5,117,+
66,27,11,98,202,+
22,34,58,81,195,+
64,47,72,18,201,+
3,94,21,73,191,+
89,47,58,26,220,+
37,19,43,49,148,+
71,83,84,58,296,+
63,64,84,49,260,+
85,97,61,22,265,+
92,17,98,16,223,+
35,10,44,66,155,+
86,59,72,17,234,+
33,81,89,8,211,+
47,78,33,22,180,+
55,29,77,85,246,+
59,17,90,87,253,+
83,31,43,31,188,+
80,3,24,72,179,+
72,88,47,97,304,+
48,85,89,87,309,+
77,63,76,57,273,+
26,90,56,91,263,+
89,82,43,79,293,+
96,10,31,44,181,+
91,73,17,84,265,+
12,5,64,9,90,+
76,13,70,25,184,+
1,27,43,72,143,+
34,68,8,9,119,+
82,80,7,38,207,+
58,68,96,14,236,+
90,17,53,65,225,+
29,80,46,7,162,+
24,46,81,11,162,+
83,22,39,37,181,+
85,31,69,67,252,+
51,93,12,1,157,+
30,36,61,96,223,+
53,88,82,65,288,+
16,45,46,35,142,+
88,82,7,40,217,+
23,35,86,37,181,+
40,43,26,20,129,+
31,32,22,36,121,+
15,22,50,13,100,+
61,7,35,7,110,+
13,39,20,95,167,+
34,91,95,58,278,+
97,68,92,61,318,+
0,22,72,0,94,+
9,39,22,27,97,+
71,24,16,44,155,+
32,70,60,43,205,+
94,13,91,2,200,+
98,6,86,73,263,+
47,93,90,28,258,+
60,8,98,79,245,+
10,64,43,76,193,+
24,87,70,72,253,+
22,62,78,63,225,+
32,88,86,48,254,+
29,46,99,54,228,+
49,53,2,37,141,+
50,38,59,45,192,+
64,18,52,79,213,+
52,97,75,9,233,+
53,95,22,32,202,+
59,34,13,5,111,+
80,92,10,68,250,+
66,76,75,41,258,+
76,53,48,40,217,+
59,10,21,48,138,+
28,2,62,44,136,+
78,52,8,19,157,+
48,79,56,61,244,+
17,99,15,54,185,+
66,71,24,9,170,+
68,37,88,83,276,+
37,98,58,61,254,+
83,17,34,0,134,+
27,69,72,90,258,+
19,37,45,21,122,+
65,63,69,79,276,+
90,57,94,82,323,+
25,25,86,3,139,+
20,82,28,26,156,+
68,76,46,2,192,+
44,1,20,12,77,+
97,71,32,57,257,+
72,95,85,58,310,+
34,34,64,66,198,+
72,0,99,3,174,+
28,24,40,55,147,+
23,53,38,2,116,+
6,36,50,36,128,+
11,98,45,51,205,+
4,46,94,0,144,+
10,20,75,33,138,+
32,78,46,51,207,+
81,20,5,41,147,+
56,62,62,23,203,+
80,94,28,75,277,+
34,43,10,98,185,+
23,97,55,23,198,+
36,1,82,42,161,+
57,39,78,98,272,+
71,31,35,57,194,+
42,49,25,71,187,+
83,45,42,69,239,+
97,53,19,73,242,+
73,19,8,69,169,+
74,7,59,35,175,+
9,16,99,47,171,+
99,65,96,11,271,+
81,34,86,76,277,+
87,75,79,53,294,+
76,86,46,54,262,+
23,79,34,27,163,+
61,71,54,47,233,+
87,96,83,12,278,+
97,62,63,34,256,+
43,55,54,99,251,+
1,41,12,5,59,+
62,84,56,34,236,+
36,98,46,85,265,+
34,1,88,67,190,+
46,63,9,97,215,+
40,13,64,98,215,+
8,35,24,83,150,+
82,79,67,19,247,+
70,95,28,66,259,+
86,92,89,28,295,+
18,22,41,85,166,+
26,33,94,51,204,+
68,37,75,79,259,+
77,68,68,23,236,+
67,84,64,1,216,+
78,22,78,27,205,+
74,97,91,5,267,+
88,40,75,95,298,+
81,74,99,33,287,+
45,91,11,54,201,+
15,20,71,22,128,+
32,29,5,68,134,+
79,87,71,34,271,+
5,12,84,81,182,+
36,52,36,71,195,+
26,47,90,52,215,+
17,61,38,89,205,+
22,43,37,74,176,+
40,21,3,55,119,+
30,20,31,2,83,+
14,32,65,75,186,+
79,72,7,82,240,+
48,70,49,77,244,+
29,25,8,33,95,+
89,89,29,3,210,+
50,40,8,53,151,+
67,95,42,57,261,+
48,6,98,91,243,+
50,10,13,71,144,+
86,97,3,3,189,+
17,43,78,94,232,+
56,55,22,1,134,+
43,80,93,94,310,+
33,1,56,89,179,+
91,38,40,23,192,+
48,63,17,4,132,+
84,24,10,98,216,+
86,20,4,71,181,+
28,87,83,86,284,+
11,93,96,5,205,+
71,12,2,56,141,+
82,10,40,82,214,+
33,57,0,67,157,+
67,96,46,16,225,+
19,47,51,1,118,+
39,71,63,75,248,+
91,19,92,6,208,+
99,35,23,3,160,+
56,14,23,19,112,+
47,79,27,61,214,+
93,51,29,29,202,+
14,18,56,57,145,+
67,55,88,20,230,+
50,80,93,5,228,+
5,55,68,33,161,+
46,51,76,57,230,+
27,68,59,97,251,+
23,68,8,69,168,+
86,10,29,82,207,+
67,10,6,23,106,+
67,56,83,1,207,+
87,55,90,84,316,+
75,5,15,21,116,+
7,57,59,46,169,+
55,63,40,20,178,+
95,39,83,11,228,+
57,77,78,15,227,+
74,13,20,74,181,+
78,23,65,10,176,+
92,10,37,69,208,+
74,34,93,40,241,+
91,1,88,32,212,+
16,31,42,49,138,+
69,77,77,38,261,+
22,46,65,70,203,+
96,81,61,26,264,+
96,73,30,12,211,+
84,71,53,60,268,+
89,34,24,41,188,+
89,92,84,2,267,+
77,52,71,86,286,+
5,48,31,93,177,+
53,2,68,23,146,+
7,37,21,37,102,+
15,62,14,99,190,+
90,6,97,9,202,+
24,43,77,35,179,+
22,61,85,26,194,+
61,75,33,21,190,+
84,79,0,50,213,+
69,53,52,46,220,+
85,44,98,57,284,+
12,91,88,76,267,+
84,60,85,51,280,+
2,93,81,88,264,+
70,40,30,7,147,+
90,21,30,65,206,+
52,45,11,12,120,+
14,29,33,57,133,+
74,7,11,30,122,+
74,77,58,16,225,+
9,23,32,25,89,+
85,90,29,33,237,+
61,19,14,53,147,+
10,19,46,38,113,+
97,38,58,10,203,+
73,20,47,6,146,+
44,27,19,28,118,+
87,99,20,98,304,+
51,4,42,25,122,+
38,60,54,89,241,+
30,35,90,55,210,+
67,62,15,75,219,+
22,78,61,65,226,+
42,66,82,80,270,+
4,86,33,27,150,+
87,16,20,69,192,+
29,40,64,39,172,+
76,23,42,31,172,+
19,48,10,82,159,+
26,57,4,2,89,+
80,34,98,86,298,+
8,35,32,59,134,+
62,44,41,97,244,+
75,45,27,47,194,+
41,24,2,44,111,+
32,49,52,83,216,+
28,27,65,81,201,+
23,59,57,56,195,+
12,93,92,21,218,+
5,71,63,23,162,+
54,42,93,81,270,+
17,83,93,64,257,+
72,51,12,18,153,+
35,20,1,16,72,+
85,92,80,39,296,+
17,44,57,80,198,+
13,44,14,87,158,+
3,27,92,8,130,+
58,99,4,4,165,+
12,45,37,98,192,+
53,6,45,57,161,+
53,50,80,84,267,+
83,51,6,49,189,+
76,0,13,72,161,+
33,64,55,50,202,+
57,48,42,20,167,+
78,7,18,16,119,+
37,16,12,14,79,+
91,79,87,99,356,+
15,70,59,67,211,+
25,8,77,63,173,+
13,42,60,99,214,+
45,54,43,84,226,+
42,22,82,36,182,+
92,49,59,75,275,+
61,86,77,32,256,+
50,78,36,34,198,+
61,11,78,12,162,+
84,8,57,5,154,+
4,89,18,21,132,+
9,95,11,1,116,+
54,3,56,17,130,+
39,25,95,67,226,+
81,70,89,67,307,+
72,89,47,20,228,+
93,11,84,33,221,+
74,96,32,88,290,+
61,89,1,19,170,+
49,29,15,46,139,+
30,52,43,85,210,+
29,14,64,98,205,+
9,80,14,95,198,+
98,86,51,94,329,+
46,56,27,73,202,+
84,16,79,53,232,+
11,95,61,48,215,+
71,71,78,59,279,+
54,97,61,79,291,+
30,43,4,48,125,+
90,64,46,91,291,+
21,12,57,83,173,+
85,34,44,55,218,+
6,26,78,88,198,+
85,1,3,53,142,+
81,43,57,59,240,+
55,48,40,67,210,+
6,34,16,22,78,+
69,9,97,14,189,+
76,19,45,53,193,+
41,87,67,28,223,+
97,22,53,65,237,+
58,54,50,87,249,+
29,13,22,65,129,+
18,91,13,83,205,+
48,59,94,62,263,+
54,88,70,22,234,+
29,47,76,56,208,+
10,32,21,56,119,+
77,60,87,53,277,+
71,89,17,87,264,+
57,40,8,26,131,+
37,32,73,55,197,+
24,53,8,52,137,+
48,45,52,46,191,+
79,3,47,9,138,+
11,33,60,85,189,+
4,37,23,66,130,+
53,16,49,65,183,+
13,68,46,82,209,+
26,70,11,12,119,+
20,45,33,45,143,+
99,70,19,17,205,+
66,79,7,71,223,+
27,64,13,71,175,+
42,94,12,69,217,+
58,17,33,59,167,+
98,9,18,74,199,+
9,94,18,62,183,+
36,13,24,36,109,+
58,46,60,85,249,+
25,36,42,73,176,+
4,30,18,74,126,+
67,36,34,78,215,+
40,86,4,26,156,+
80,53,76,36,245,+
72,31,72,78,253,+
53,99,51,87,290,+
72,58,46,95,271,+
7,72,12,43,134,+
77,28,4,65,174,+
73,15,29,2,119,+
95,24,59,74,252,+
7,98,31,82,218,+
6,27,27,8,68,+
94,79,8,32,213,+
76,18,69,77,240,+
19,50,7,70,146,+
10,39,58,31,138,+
0,59,53,56,168,+
41,25,50,33,149,+
69,85,57,38,249,+
33,5,47,14,99,+
5,45,54,54,158,+
20,82,53,90,245,+
14,53,24,28,119,+
39,47,55,20,161,+
40,25,75,71,211,+
50,68,15,86,219,+
75,96,13,9,193,+
40,70,54,94,258,+
27,43,10,79,159,+
23,39,85,6,153,+
51,27,84,31,193,+
95,7,64,43,209,+
82,43,69,96,290,+
9,64,18,10,101,+
94,82,72,38,286,+
81,7,50,5,143,+
65,78,58,54,255,+
71,57,88,4,220,+
90,42,17,32,181,+
32,23,9,78,142,+
31,12,64,57,164,+
9,66,52,84,211,+
74,83,89,17,263,+
33,82,35,67,217,+
68,59,6,2,135,+
57,92,13,83,245,+
36,6,49,85,176,+
32,92,45,97,266,+
63,34,6,14,117,+
75,35,97,30,237,+
4,91,96,89,280,+
39,93,17,33,182,+
80,61,71,82,294,+
29,9,49,81,168,+
75,44,11,32,162,+
38,95,84,58,275,+
84,96,37,4,221,+
71,89,6,11,177,+
76,83,60,93,312,+
29,92,35,61,217,+
1,83,63,75,222,+
54,57,15,84,210,+
99,70,97,84,350,+
92,25,53,37,207,+
63,52,34,61,210,+
86,77,29,65,257,+
75,5,95,36,211,+
87,59,94,25,265,+
93,54,12,64,223,+
29,37,33,63,162,+
22,67,44,73,206,+
1,33,82,98,214,+
86,30,24,20,160,+
37,84,0,62,183,+
57,8,66,1,132,+
7,43,98,72,220,+
8,35,28,69,140,+
50,67,89,43,249,+
64,6,27,13,110,+
19,43,50,74,186,+
10,36,6,40,92,+
75,64,72,99,310,+
23,29,92,97,241,+
50,23,47,53,173,+
15,71,23,65,174,+
94,26,86,29,235,+
15,19,33,73,140,+
14,40,19,16,89,+
43,53,78,17,191,+
86,46,21,37,190,+
46,95,1,85,227,+
89,27,77,34,227,+
71,72,69,38,250,+
81,10,83,95,269,+
96,23,23,84,226,+
61,85,66,6,218,+
52,70,99,27,248,+
35,1,5,36,77,+
52,57,71,89,269,+
65,80,93,61,299,+
78,93,61,8,240,+
80,28,12,30,150,+
43,2,79,21,145,+
61,65,1,54,181,+
37,81,30,66,214,+
66,76,94,0,236,+
89,38,22,18,167,+
29,14,91,11,145,+
59,66,89,81,295,+
24,94,26,13,157,+
14,58,88,38,198,+
57,87,64,34,242,+
44,12,57,77,190,+
91,32,82,93,298,+
58,81,23,29,191,+
98,78,18,23,217,+
85,31,18,19,153,+
4,46,21,48,119,+
36,46,1,82,165,+
26,11,55,90,182,+
95,6,42,26,169,+
85,71,66,25,247,+
3,95,45,39,182,+
98,4,98,45,245,+
70,62,93,83,308,+
63,40,23,63,189,+
26,85,67,44,222,+
90,47,62,76,275,+
32,49,68,38,187,+
32,78,37,22,169,+
3,39,5,45,92,+
99,31,37,42,209,+
49,19,98,13,179,+
59,26,25,16,126,+
51,29,41,63,184,+
29,43,35,78,185,+
96,74,51,2,223,+
83,33,24,47,187,+
28,96,95,41,260,+
20,1,27,38,86,+
73,59,73,7,212,+
88,42,70,22,222,+
21,68,13,54,156,+
97,44,9,2,152,+
76,54,62,80,272,+
99,60,72,14,245,+
28,56,16,58,158,+
80,50,87,7,224,+
36,46,88,42,212,+
64,11,53,37,165,+
39,73,34,5,151,+
96,32,67,43,238,+
72,58,23,6,159,+
28,0,3,7,38,+
92,82,54,99,327,+
64,11,5,29,109,+
88,0,99,9,196,+
42,36,91,1,170,+
36,86,87,47,256,+
67,88,10,55,220,+
23,49,70,64,206,+
46,4,38,80,168,+
69,48,36,1,154,+
71,47,0,66,184,+
10,51,25,25,111,+
62,25,70,22,179,+
63,22,57,7,149,+
79,80,37,68,264,+
83,66,91,53,293,+
92,21,80,64,257,+
14,22,95,63,194,+
42,9,17,15,83,+
74,35,5,60,174,+
3,90,10,3,106,+
47,6,36,50,139,+
29,29,21,97,176,+
64,2,18,17,101,+
88,23,57,98,266,+
93,32,48,23,196,+
10,32,53,18,113,+
9,95,57,36,197,+
19,98,76,18,211,+
57,96,32,88,273,+
72,42,84,78,276,+
70,97,18,69,254,+
59,80,78,24,241,+
16,48,23,31,118,+
11,46,39,62,158,+
71,54,12,75,212,+
31,55,39,61,186,+
17,89,73,63,242,+
23,16,12,69,120,+
95,79,28,7,209,+
36,12,61,34,143,+
79,7,50,71,207,+
65,33,91,72,261,+
86,51,83,23,243,+
21,24,19,86,150,+
54,96,28,62,240,+
1,12,98,30,141,+
22,65,18,74,179,+
92,46,71,15,224,+
19,56,36,65,176,+
81,60,90,24,255,+
53,4,37,55,149,+
5,70,44,20,139,+