value_a,value_b,value_c,value_d,result,operation
1,91,1,25,118,+
0,18,50,74,142,+
64,74,89,39,266,+
28,3,21,67,119,+
85,45,32,61,223,+
6,36,31,7,80,+
24,9,9,87,129,+
37,62,82,22,203,+
35,55,27,79,196,+
27,19,56,99,201,+